PokerStars Hand #139417497046: Tournament #1292680929, $10+$1 USD Hold'em No Limit - Level I (10/20) - 2015/08/15 13:15:18 ET
Table '1292680929 17' 9-max Seat #1 is the button
Seat 1: RoyalBluf NL (3000 in chips) 
Seat 2: rastamanooo (3000 in chips) 
Seat 3: liamkid (3000 in chips) 
Seat 4: R@nTAnpl@N (3000 in chips) 
Seat 5: Skollpada (3000 in chips) 
Seat 7: LtGrimms (3000 in chips) 
Seat 8: Adios89 (3000 in chips) 
Seat 9: Liskacha (3000 in chips) 
rastamanooo: posts small blind 10
liamkid: posts big blind 20
*** HOLE CARDS ***
Dealt to LtGrimms [6c Ac]
R@nTAnpl@N: raises 40 to 60
Skollpada: folds 
LtGrimms: calls 60
Adios89: folds 
Liskacha: folds 
RoyalBluf NL: folds 
rastamanooo: folds 
liamkid: folds 
*** FLOP *** [Kh 8h 7d]
R@nTAnpl@N: bets 76
LtGrimms: folds 
Uncalled bet (76) returned to R@nTAnpl@N
R@nTAnpl@N collected 150 from pot
*** SUMMARY ***
Total pot 150 | Rake 0 
Board [Kh 8h 7d]
Seat 1: RoyalBluf NL (button) folded before Flop (didn't bet)
Seat 2: rastamanooo (small blind) folded before Flop
Seat 3: liamkid (big blind) folded before Flop
Seat 4: R@nTAnpl@N collected (150)
Seat 5: Skollpada folded before Flop (didn't bet)
Seat 7: LtGrimms folded on the Flop
Seat 8: Adios89 folded before Flop (didn't bet)
Seat 9: Liskacha folded before Flop (didn't bet)



PokerStars Hand #139417523456: Tournament #1292680929, $10+$1 USD Hold'em No Limit - Level I (10/20) - 2015/08/15 13:15:57 ET
Table '1292680929 17' 9-max Seat #2 is the button
Seat 1: RoyalBluf NL (3000 in chips) 
Seat 2: rastamanooo (2990 in chips) 
Seat 3: liamkid (2980 in chips) 
Seat 4: R@nTAnpl@N (3090 in chips) 
Seat 5: markxx311 (3000 in chips) 
Seat 6: mecco (3000 in chips) 
Seat 7: LtGrimms (2940 in chips) 
Seat 8: Adios89 (3000 in chips) 
Seat 9: Liskacha (3000 in chips) 
liamkid: posts small blind 10
R@nTAnpl@N: posts big blind 20
*** HOLE CARDS ***
Dealt to LtGrimms [5h Th]
markxx311: folds 
mecco: folds 
LtGrimms: folds 
Adios89: folds 
Liskacha: folds 
RoyalBluf NL: folds 
rastamanooo: folds 
liamkid: folds 
Uncalled bet (10) returned to R@nTAnpl@N
R@nTAnpl@N collected 20 from pot
*** SUMMARY ***
Total pot 20 | Rake 0 
Seat 1: RoyalBluf NL folded before Flop (didn't bet)
Seat 2: rastamanooo (button) folded before Flop (didn't bet)
Seat 3: liamkid (small blind) folded before Flop
Seat 4: R@nTAnpl@N (big blind) collected (20)
Seat 5: markxx311 folded before Flop (didn't bet)
Seat 6: mecco folded before Flop (didn't bet)
Seat 7: LtGrimms folded before Flop (didn't bet)
Seat 8: Adios89 folded before Flop (didn't bet)
Seat 9: Liskacha folded before Flop (didn't bet)



PokerStars Hand #139417544445: Tournament #1292680929, $10+$1 USD Hold'em No Limit - Level I (10/20) - 2015/08/15 13:16:29 ET
Table '1292680929 17' 9-max Seat #3 is the button
Seat 1: RoyalBluf NL (3000 in chips) 
Seat 2: rastamanooo (2990 in chips) 
Seat 3: liamkid (2970 in chips) 
Seat 4: R@nTAnpl@N (3100 in chips) 
Seat 5: markxx311 (3000 in chips) 
Seat 6: mecco (3000 in chips) 
Seat 7: LtGrimms (2940 in chips) 
Seat 8: Adios89 (3000 in chips) 
Seat 9: Liskacha (3000 in chips) 
R@nTAnpl@N: posts small blind 10
markxx311: posts big blind 20
*** HOLE CARDS ***
Dealt to LtGrimms [3h 3s]
mecco: folds 
LtGrimms: raises 30 to 50
Adios89: folds 
Liskacha: folds 
RoyalBluf NL: folds 
rastamanooo: folds 
rastamanooo is sitting out
liamkid: folds 
R@nTAnpl@N: folds 
markxx311: folds 
Uncalled bet (30) returned to LtGrimms
LtGrimms collected 50 from pot
*** SUMMARY ***
Total pot 50 | Rake 0 
Seat 1: RoyalBluf NL folded before Flop (didn't bet)
Seat 2: rastamanooo folded before Flop (didn't bet)
Seat 3: liamkid (button) folded before Flop (didn't bet)
Seat 4: R@nTAnpl@N (small blind) folded before Flop
Seat 5: markxx311 (big blind) folded before Flop
Seat 6: mecco folded before Flop (didn't bet)
Seat 7: LtGrimms collected (50)
Seat 8: Adios89 folded before Flop (didn't bet)
Seat 9: Liskacha folded before Flop (didn't bet)



PokerStars Hand #139417582977: Tournament #1292680929, $10+$1 USD Hold'em No Limit - Level I (10/20) - 2015/08/15 13:17:26 ET
Table '1292680929 17' 9-max Seat #4 is the button
Seat 1: RoyalBluf NL (3000 in chips) 
Seat 2: rastamanooo (2990 in chips) is sitting out
Seat 3: liamkid (2970 in chips) 
Seat 4: R@nTAnpl@N (3090 in chips) 
Seat 5: markxx311 (2980 in chips) 
Seat 6: mecco (3000 in chips) 
Seat 7: LtGrimms (2970 in chips) 
Seat 8: Adios89 (3000 in chips) 
Seat 9: Liskacha (3000 in chips) 
markxx311: posts small blind 10
mecco: posts big blind 20
*** HOLE CARDS ***
Dealt to LtGrimms [As 3h]
LtGrimms: folds 
Adios89: folds 
Liskacha: folds 
RoyalBluf NL: folds 
rastamanooo: folds 
liamkid: folds 
R@nTAnpl@N: folds 
rastamanooo has returned
markxx311: folds 
Uncalled bet (10) returned to mecco
mecco collected 20 from pot
mecco: doesn't show hand 
*** SUMMARY ***
Total pot 20 | Rake 0 
Seat 1: RoyalBluf NL folded before Flop (didn't bet)
Seat 2: rastamanooo folded before Flop (didn't bet)
Seat 3: liamkid folded before Flop (didn't bet)
Seat 4: R@nTAnpl@N (button) folded before Flop (didn't bet)
Seat 5: markxx311 (small blind) folded before Flop
Seat 6: mecco (big blind) collected (20)
Seat 7: LtGrimms folded before Flop (didn't bet)
Seat 8: Adios89 folded before Flop (didn't bet)
Seat 9: Liskacha folded before Flop (didn't bet)



PokerStars Hand #139417610320: Tournament #1292680929, $10+$1 USD Hold'em No Limit - Level I (10/20) - 2015/08/15 13:18:07 ET
Table '1292680929 17' 9-max Seat #5 is the button
Seat 2: rastamanooo (2990 in chips) 
Seat 3: liamkid (2970 in chips) 
Seat 4: R@nTAnpl@N (3090 in chips) 
Seat 5: markxx311 (2970 in chips) 
Seat 6: mecco (3010 in chips) 
Seat 7: LtGrimms (2970 in chips) 
Seat 8: Adios89 (3000 in chips) 
Seat 9: Liskacha (3000 in chips) 
mecco: posts small blind 10
LtGrimms: posts big blind 20
*** HOLE CARDS ***
Dealt to LtGrimms [As 5h]
Adios89: folds 
Liskacha: folds 
rastamanooo: folds 
liamkid: folds 
R@nTAnpl@N: folds 
markxx311: folds 
mecco: raises 40 to 60
LtGrimms: calls 40
*** FLOP *** [Qc Ad Td]
mecco: checks 
LtGrimms: bets 70
mecco: calls 70
*** TURN *** [Qc Ad Td] [8d]
mecco: checks 
LtGrimms: bets 170
mecco: folds 
Uncalled bet (170) returned to LtGrimms
LtGrimms collected 260 from pot
*** SUMMARY ***
Total pot 260 | Rake 0 
Board [Qc Ad Td 8d]
Seat 2: rastamanooo folded before Flop (didn't bet)
Seat 3: liamkid folded before Flop (didn't bet)
Seat 4: R@nTAnpl@N folded before Flop (didn't bet)
Seat 5: markxx311 (button) folded before Flop (didn't bet)
Seat 6: mecco (small blind) folded on the Turn
Seat 7: LtGrimms (big blind) collected (260)
Seat 8: Adios89 folded before Flop (didn't bet)
Seat 9: Liskacha folded before Flop (didn't bet)



PokerStars Hand #139417668474: Tournament #1292680929, $10+$1 USD Hold'em No Limit - Level I (10/20) - 2015/08/15 13:19:33 ET
Table '1292680929 17' 9-max Seat #6 is the button
Seat 1: Kova4A (3000 in chips) 
Seat 2: rastamanooo (2990 in chips) 
Seat 3: liamkid (2970 in chips) 
Seat 4: R@nTAnpl@N (3090 in chips) 
Seat 5: markxx311 (2970 in chips) 
Seat 6: mecco (2880 in chips) 
Seat 7: LtGrimms (3100 in chips) 
Seat 8: Adios89 (3000 in chips) 
Seat 9: Liskacha (3000 in chips) 
LtGrimms: posts small blind 10
Adios89: posts big blind 20
*** HOLE CARDS ***
Dealt to LtGrimms [Td 3s]
Liskacha: folds 
Kova4A: folds 
rastamanooo: raises 40 to 60
liamkid: folds 
R@nTAnpl@N: folds 
markxx311: folds 
mecco: folds 
LtGrimms: folds 
Adios89: folds 
Uncalled bet (40) returned to rastamanooo
rastamanooo collected 50 from pot
rastamanooo: doesn't show hand 
*** SUMMARY ***
Total pot 50 | Rake 0 
Seat 1: Kova4A folded before Flop (didn't bet)
Seat 2: rastamanooo collected (50)
Seat 3: liamkid folded before Flop (didn't bet)
Seat 4: R@nTAnpl@N folded before Flop (didn't bet)
Seat 5: markxx311 folded before Flop (didn't bet)
Seat 6: mecco (button) folded before Flop (didn't bet)
Seat 7: LtGrimms (small blind) folded before Flop
Seat 8: Adios89 (big blind) folded before Flop
Seat 9: Liskacha folded before Flop (didn't bet)



PokerStars Hand #139417689039: Tournament #1292680929, $10+$1 USD Hold'em No Limit - Level I (10/20) - 2015/08/15 13:20:03 ET
Table '1292680929 17' 9-max Seat #7 is the button
Seat 1: Kova4A (3000 in chips) 
Seat 2: rastamanooo (3020 in chips) 
Seat 3: liamkid (2970 in chips) 
Seat 4: R@nTAnpl@N (3090 in chips) 
Seat 5: markxx311 (2970 in chips) 
Seat 6: mecco (2880 in chips) 
Seat 7: LtGrimms (3090 in chips) 
Seat 8: Adios89 (2980 in chips) 
Seat 9: Liskacha (3000 in chips) 
Adios89: posts small blind 10
Liskacha: posts big blind 20
*** HOLE CARDS ***
Dealt to LtGrimms [6s 4c]
Kova4A: folds 
rastamanooo: folds 
liamkid: folds 
R@nTAnpl@N: raises 40 to 60
markxx311: calls 60
mecco: folds 
LtGrimms: folds 
Adios89: folds 
Liskacha: folds 
*** FLOP *** [5h 8d 8c]
R@nTAnpl@N: bets 99
markxx311: folds 
Uncalled bet (99) returned to R@nTAnpl@N
R@nTAnpl@N collected 150 from pot
*** SUMMARY ***
Total pot 150 | Rake 0 
Board [5h 8d 8c]
Seat 1: Kova4A folded before Flop (didn't bet)
Seat 2: rastamanooo folded before Flop (didn't bet)
Seat 3: liamkid folded before Flop (didn't bet)
Seat 4: R@nTAnpl@N collected (150)
Seat 5: markxx311 folded on the Flop
Seat 6: mecco folded before Flop (didn't bet)
Seat 7: LtGrimms (button) folded before Flop (didn't bet)
Seat 8: Adios89 (small blind) folded before Flop
Seat 9: Liskacha (big blind) folded before Flop



PokerStars Hand #139417724686: Tournament #1292680929, $10+$1 USD Hold'em No Limit - Level I (10/20) - 2015/08/15 13:20:57 ET
Table '1292680929 17' 9-max Seat #8 is the button
Seat 1: Kova4A (3000 in chips) 
Seat 2: rastamanooo (3020 in chips) 
Seat 3: liamkid (2970 in chips) 
Seat 4: R@nTAnpl@N (3180 in chips) 
Seat 5: markxx311 (2910 in chips) 
Seat 6: mecco (2880 in chips) 
Seat 7: LtGrimms (3090 in chips) 
Seat 8: Adios89 (2970 in chips) 
Seat 9: Liskacha (2980 in chips) 
Liskacha: posts small blind 10
Kova4A: posts big blind 20
*** HOLE CARDS ***
Dealt to LtGrimms [Jc Ks]
rastamanooo: folds 
liamkid: raises 40 to 60
R@nTAnpl@N: folds 
markxx311: folds 
mecco: folds 
LtGrimms: calls 60
Adios89: folds 
Liskacha: folds 
Kova4A: folds 
*** FLOP *** [Jd 2h 5h]
liamkid: bets 75
LtGrimms: raises 225 to 300
liamkid: folds 
Uncalled bet (225) returned to LtGrimms
LtGrimms collected 300 from pot
*** SUMMARY ***
Total pot 300 | Rake 0 
Board [Jd 2h 5h]
Seat 1: Kova4A (big blind) folded before Flop
Seat 2: rastamanooo folded before Flop (didn't bet)
Seat 3: liamkid folded on the Flop
Seat 4: R@nTAnpl@N folded before Flop (didn't bet)
Seat 5: markxx311 folded before Flop (didn't bet)
Seat 6: mecco folded before Flop (didn't bet)
Seat 7: LtGrimms collected (300)
Seat 8: Adios89 (button) folded before Flop (didn't bet)
Seat 9: Liskacha (small blind) folded before Flop



PokerStars Hand #139417752293: Tournament #1292680929, $10+$1 USD Hold'em No Limit - Level I (10/20) - 2015/08/15 13:21:38 ET
Table '1292680929 17' 9-max Seat #9 is the button
Seat 1: Kova4A (2980 in chips) 
Seat 2: rastamanooo (3020 in chips) 
Seat 3: liamkid (2835 in chips) 
Seat 4: R@nTAnpl@N (3180 in chips) 
Seat 5: markxx311 (2910 in chips) 
Seat 6: mecco (2880 in chips) 
Seat 7: LtGrimms (3255 in chips) 
Seat 8: Adios89 (2970 in chips) 
Seat 9: Liskacha (2970 in chips) 
Kova4A: posts small blind 10
rastamanooo: posts big blind 20
*** HOLE CARDS ***
Dealt to LtGrimms [4d 5h]
liamkid: folds 
R@nTAnpl@N: folds 
markxx311: folds 
mecco: folds 
LtGrimms: raises 30 to 50
Adios89: folds 
Liskacha: calls 50
Kova4A: folds 
rastamanooo: folds 
*** FLOP *** [Js Tc Qc]
LtGrimms: checks 
Liskacha: checks 
*** TURN *** [Js Tc Qc] [Th]
LtGrimms: checks 
Liskacha: bets 70
LtGrimms: folds 
Uncalled bet (70) returned to Liskacha
Liskacha collected 130 from pot
Liskacha: doesn't show hand 
*** SUMMARY ***
Total pot 130 | Rake 0 
Board [Js Tc Qc Th]
Seat 1: Kova4A (small blind) folded before Flop
Seat 2: rastamanooo (big blind) folded before Flop
Seat 3: liamkid folded before Flop (didn't bet)
Seat 4: R@nTAnpl@N folded before Flop (didn't bet)
Seat 5: markxx311 folded before Flop (didn't bet)
Seat 6: mecco folded before Flop (didn't bet)
Seat 7: LtGrimms folded on the Turn
Seat 8: Adios89 folded before Flop (didn't bet)
Seat 9: Liskacha (button) collected (130)



PokerStars Hand #139417788855: Tournament #1292680929, $10+$1 USD Hold'em No Limit - Level I (10/20) - 2015/08/15 13:22:33 ET
Table '1292680929 17' 9-max Seat #1 is the button
Seat 1: Kova4A (2970 in chips) 
Seat 2: rastamanooo (3000 in chips) 
Seat 3: liamkid (2835 in chips) 
Seat 4: R@nTAnpl@N (3180 in chips) 
Seat 5: markxx311 (2910 in chips) 
Seat 6: mecco (2880 in chips) 
Seat 7: LtGrimms (3205 in chips) 
Seat 8: Adios89 (2970 in chips) 
Seat 9: Liskacha (3050 in chips) 
rastamanooo: posts small blind 10
liamkid: posts big blind 20
*** HOLE CARDS ***
Dealt to LtGrimms [Kd Jd]
R@nTAnpl@N: raises 21 to 41
markxx311: raises 21 to 62
mecco: folds 
LtGrimms: calls 62
Adios89: folds 
Liskacha: folds 
Kova4A: folds 
rastamanooo: folds 
liamkid: folds 
R@nTAnpl@N: calls 21
*** FLOP *** [3d 2h 7s]
R@nTAnpl@N: checks 
markxx311: bets 162
LtGrimms: folds 
R@nTAnpl@N: folds 
Uncalled bet (162) returned to markxx311
markxx311 collected 216 from pot
*** SUMMARY ***
Total pot 216 | Rake 0 
Board [3d 2h 7s]
Seat 1: Kova4A (button) folded before Flop (didn't bet)
Seat 2: rastamanooo (small blind) folded before Flop
Seat 3: liamkid (big blind) folded before Flop
Seat 4: R@nTAnpl@N folded on the Flop
Seat 5: markxx311 collected (216)
Seat 6: mecco folded before Flop (didn't bet)
Seat 7: LtGrimms folded on the Flop
Seat 8: Adios89 folded before Flop (didn't bet)
Seat 9: Liskacha folded before Flop (didn't bet)



PokerStars Hand #139417846038: Tournament #1292680929, $10+$1 USD Hold'em No Limit - Level I (10/20) - 2015/08/15 13:23:58 ET
Table '1292680929 17' 9-max Seat #2 is the button
Seat 1: Kova4A (2970 in chips) 
Seat 2: rastamanooo (2990 in chips) 
Seat 3: liamkid (2815 in chips) 
Seat 4: R@nTAnpl@N (3118 in chips) 
Seat 5: markxx311 (3064 in chips) 
Seat 6: mecco (2880 in chips) 
Seat 7: LtGrimms (3143 in chips) 
Seat 8: Adios89 (2970 in chips) 
Seat 9: Liskacha (3050 in chips) 
liamkid: posts small blind 10
R@nTAnpl@N: posts big blind 20
*** HOLE CARDS ***
Dealt to LtGrimms [2c 2d]
markxx311: raises 40 to 60
mecco: folds 
LtGrimms: folds 
Adios89: folds 
Liskacha: folds 
Kova4A: folds 
rastamanooo: folds 
liamkid: folds 
R@nTAnpl@N: calls 40
*** FLOP *** [3s 9s Kh]
R@nTAnpl@N: checks 
markxx311: bets 65
R@nTAnpl@N: folds 
Uncalled bet (65) returned to markxx311
markxx311 collected 130 from pot
*** SUMMARY ***
Total pot 130 | Rake 0 
Board [3s 9s Kh]
Seat 1: Kova4A folded before Flop (didn't bet)
Seat 2: rastamanooo (button) folded before Flop (didn't bet)
Seat 3: liamkid (small blind) folded before Flop
Seat 4: R@nTAnpl@N (big blind) folded on the Flop
Seat 5: markxx311 collected (130)
Seat 6: mecco folded before Flop (didn't bet)
Seat 7: LtGrimms folded before Flop (didn't bet)
Seat 8: Adios89 folded before Flop (didn't bet)
Seat 9: Liskacha folded before Flop (didn't bet)



PokerStars Hand #139417899730: Tournament #1292680929, $10+$1 USD Hold'em No Limit - Level I (10/20) - 2015/08/15 13:25:17 ET
Table '1292680929 17' 9-max Seat #3 is the button
Seat 1: Kova4A (2970 in chips) 
Seat 2: rastamanooo (2990 in chips) 
Seat 3: liamkid (2805 in chips) 
Seat 4: R@nTAnpl@N (3058 in chips) 
Seat 5: markxx311 (3134 in chips) 
Seat 6: mecco (2880 in chips) 
Seat 7: LtGrimms (3143 in chips) 
Seat 8: Adios89 (2970 in chips) 
Seat 9: Liskacha (3050 in chips) 
R@nTAnpl@N: posts small blind 10
markxx311: posts big blind 20
*** HOLE CARDS ***
Dealt to LtGrimms [2s 2d]
mecco: folds 
LtGrimms: raises 30 to 50
Adios89: folds 
Liskacha: folds 
Kova4A: folds 
rastamanooo: folds 
liamkid: folds 
R@nTAnpl@N: raises 190 to 240
markxx311: folds 
LtGrimms: folds 
Uncalled bet (190) returned to R@nTAnpl@N
R@nTAnpl@N collected 120 from pot
*** SUMMARY ***
Total pot 120 | Rake 0 
Seat 1: Kova4A folded before Flop (didn't bet)
Seat 2: rastamanooo folded before Flop (didn't bet)
Seat 3: liamkid (button) folded before Flop (didn't bet)
Seat 4: R@nTAnpl@N (small blind) collected (120)
Seat 5: markxx311 (big blind) folded before Flop
Seat 6: mecco folded before Flop (didn't bet)
Seat 7: LtGrimms folded before Flop
Seat 8: Adios89 folded before Flop (didn't bet)
Seat 9: Liskacha folded before Flop (didn't bet)



PokerStars Hand #139417934390: Tournament #1292680929, $10+$1 USD Hold'em No Limit - Level II (15/30) - 2015/08/15 13:26:09 ET
Table '1292680929 17' 9-max Seat #4 is the button
Seat 1: Kova4A (2970 in chips) 
Seat 2: rastamanooo (2990 in chips) 
Seat 3: liamkid (2805 in chips) 
Seat 4: R@nTAnpl@N (3128 in chips) 
Seat 5: markxx311 (3114 in chips) 
Seat 6: mecco (2880 in chips) 
Seat 7: LtGrimms (3093 in chips) 
Seat 8: Adios89 (2970 in chips) 
Seat 9: Liskacha (3050 in chips) 
markxx311: posts small blind 15
mecco: posts big blind 30
*** HOLE CARDS ***
Dealt to LtGrimms [5h 3s]
LtGrimms: folds 
Adios89: raises 60 to 90
Liskacha: folds 
Kova4A: raises 165 to 255
rastamanooo: folds 
liamkid: folds 
R@nTAnpl@N: folds 
markxx311: folds 
mecco: folds 
Adios89: folds 
Uncalled bet (165) returned to Kova4A
Kova4A collected 225 from pot
Kova4A: doesn't show hand 
*** SUMMARY ***
Total pot 225 | Rake 0 
Seat 1: Kova4A collected (225)
Seat 2: rastamanooo folded before Flop (didn't bet)
Seat 3: liamkid folded before Flop (didn't bet)
Seat 4: R@nTAnpl@N (button) folded before Flop (didn't bet)
Seat 5: markxx311 (small blind) folded before Flop
Seat 6: mecco (big blind) folded before Flop
Seat 7: LtGrimms folded before Flop (didn't bet)
Seat 8: Adios89 folded before Flop
Seat 9: Liskacha folded before Flop (didn't bet)



PokerStars Hand #139417970013: Tournament #1292680929, $10+$1 USD Hold'em No Limit - Level II (15/30) - 2015/08/15 13:27:02 ET
Table '1292680929 17' 9-max Seat #5 is the button
Seat 1: Kova4A (3105 in chips) 
Seat 2: rastamanooo (2990 in chips) 
Seat 3: liamkid (2805 in chips) 
Seat 4: R@nTAnpl@N (3128 in chips) 
Seat 5: markxx311 (3099 in chips) 
Seat 6: mecco (2850 in chips) 
Seat 7: LtGrimms (3093 in chips) 
Seat 8: Adios89 (2880 in chips) 
Seat 9: Liskacha (3050 in chips) 
mecco: posts small blind 15
LtGrimms: posts big blind 30
*** HOLE CARDS ***
Dealt to LtGrimms [8c 4d]
Adios89: folds 
Liskacha: folds 
Kova4A: raises 60 to 90
rastamanooo: folds 
liamkid: folds 
R@nTAnpl@N: folds 
markxx311: folds 
mecco: folds 
LtGrimms: folds 
Uncalled bet (60) returned to Kova4A
Kova4A collected 75 from pot
Kova4A: doesn't show hand 
*** SUMMARY ***
Total pot 75 | Rake 0 
Seat 1: Kova4A collected (75)
Seat 2: rastamanooo folded before Flop (didn't bet)
Seat 3: liamkid folded before Flop (didn't bet)
Seat 4: R@nTAnpl@N folded before Flop (didn't bet)
Seat 5: markxx311 (button) folded before Flop (didn't bet)
Seat 6: mecco (small blind) folded before Flop
Seat 7: LtGrimms (big blind) folded before Flop
Seat 8: Adios89 folded before Flop (didn't bet)
Seat 9: Liskacha folded before Flop (didn't bet)



PokerStars Hand #139417995413: Tournament #1292680929, $10+$1 USD Hold'em No Limit - Level II (15/30) - 2015/08/15 13:27:40 ET
Table '1292680929 17' 9-max Seat #6 is the button
Seat 1: Kova4A (3150 in chips) 
Seat 2: rastamanooo (2990 in chips) 
Seat 3: liamkid (2805 in chips) 
Seat 4: R@nTAnpl@N (3128 in chips) 
Seat 5: markxx311 (3099 in chips) 
Seat 6: mecco (2835 in chips) 
Seat 7: LtGrimms (3063 in chips) 
Seat 8: Adios89 (2880 in chips) 
Seat 9: Liskacha (3050 in chips) 
LtGrimms: posts small blind 15
Adios89: posts big blind 30
*** HOLE CARDS ***
Dealt to LtGrimms [Jd Ah]
Liskacha: folds 
Kova4A: folds 
rastamanooo: folds 
liamkid: folds 
R@nTAnpl@N: folds 
markxx311: folds 
mecco: folds 
LtGrimms: raises 50 to 80
Adios89: folds 
Uncalled bet (50) returned to LtGrimms
LtGrimms collected 60 from pot
*** SUMMARY ***
Total pot 60 | Rake 0 
Seat 1: Kova4A folded before Flop (didn't bet)
Seat 2: rastamanooo folded before Flop (didn't bet)
Seat 3: liamkid folded before Flop (didn't bet)
Seat 4: R@nTAnpl@N folded before Flop (didn't bet)
Seat 5: markxx311 folded before Flop (didn't bet)
Seat 6: mecco (button) folded before Flop (didn't bet)
Seat 7: LtGrimms (small blind) collected (60)
Seat 8: Adios89 (big blind) folded before Flop
Seat 9: Liskacha folded before Flop (didn't bet)



PokerStars Hand #139418021829: Tournament #1292680929, $10+$1 USD Hold'em No Limit - Level II (15/30) - 2015/08/15 13:28:19 ET
Table '1292680929 17' 9-max Seat #7 is the button
Seat 1: Kova4A (3150 in chips) 
Seat 2: rastamanooo (2990 in chips) 
Seat 3: liamkid (2805 in chips) 
Seat 4: R@nTAnpl@N (3128 in chips) 
Seat 5: markxx311 (3099 in chips) 
Seat 6: mecco (2835 in chips) 
Seat 7: LtGrimms (3093 in chips) 
Seat 8: Adios89 (2850 in chips) 
Seat 9: Liskacha (3050 in chips) 
Adios89: posts small blind 15
Liskacha: posts big blind 30
*** HOLE CARDS ***
Dealt to LtGrimms [8c 5d]
Kova4A: folds 
rastamanooo: folds 
liamkid: folds 
R@nTAnpl@N: folds 
markxx311: folds 
mecco: folds 
LtGrimms: folds 
Adios89: folds 
Uncalled bet (15) returned to Liskacha
Liskacha collected 30 from pot
Liskacha: doesn't show hand 
*** SUMMARY ***
Total pot 30 | Rake 0 
Seat 1: Kova4A folded before Flop (didn't bet)
Seat 2: rastamanooo folded before Flop (didn't bet)
Seat 3: liamkid folded before Flop (didn't bet)
Seat 4: R@nTAnpl@N folded before Flop (didn't bet)
Seat 5: markxx311 folded before Flop (didn't bet)
Seat 6: mecco folded before Flop (didn't bet)
Seat 7: LtGrimms (button) folded before Flop (didn't bet)
Seat 8: Adios89 (small blind) folded before Flop
Seat 9: Liskacha (big blind) collected (30)



PokerStars Hand #139418035845: Tournament #1292680929, $10+$1 USD Hold'em No Limit - Level II (15/30) - 2015/08/15 13:28:40 ET
Table '1292680929 17' 9-max Seat #8 is the button
Seat 2: rastamanooo (2990 in chips) 
Seat 3: liamkid (2805 in chips) 
Seat 4: R@nTAnpl@N (3128 in chips) 
Seat 5: markxx311 (3099 in chips) 
Seat 6: mecco (2835 in chips) 
Seat 7: LtGrimms (3093 in chips) 
Seat 8: Adios89 (2835 in chips) 
Seat 9: Liskacha (3065 in chips) 
Liskacha: posts small blind 15
rastamanooo: posts big blind 30
*** HOLE CARDS ***
Dealt to LtGrimms [5h 6h]
liamkid: folds 
R@nTAnpl@N: folds 
markxx311: folds 
mecco: folds 
LtGrimms: raises 50 to 80
Adios89: folds 
Liskacha: raises 175 to 255
rastamanooo: folds 
LtGrimms: calls 175
*** FLOP *** [5s 9c Qd]
Liskacha is disconnected 
Liskacha has timed out while disconnected
Liskacha: checks 
LtGrimms: bets 300
Liskacha has timed out while disconnected
Liskacha: folds 
Uncalled bet (300) returned to LtGrimms
Liskacha is sitting out
LtGrimms collected 540 from pot
*** SUMMARY ***
Total pot 540 | Rake 0 
Board [5s 9c Qd]
Seat 2: rastamanooo (big blind) folded before Flop
Seat 3: liamkid folded before Flop (didn't bet)
Seat 4: R@nTAnpl@N folded before Flop (didn't bet)
Seat 5: markxx311 folded before Flop (didn't bet)
Seat 6: mecco folded before Flop (didn't bet)
Seat 7: LtGrimms collected (540)
Seat 8: Adios89 (button) folded before Flop (didn't bet)
Seat 9: Liskacha (small blind) folded on the Flop



PokerStars Hand #139418130612: Tournament #1292680929, $10+$1 USD Hold'em No Limit - Level II (15/30) - 2015/08/15 13:31:00 ET
Table '1292680929 17' 9-max Seat #9 is the button
Seat 1: gits1980 (3000 in chips) out of hand (moved from another table into small blind)
Seat 2: rastamanooo (2960 in chips) 
Seat 3: liamkid (2805 in chips) 
Seat 4: R@nTAnpl@N (3128 in chips) 
Seat 5: markxx311 (3099 in chips) 
Seat 6: mecco (2835 in chips) 
Seat 7: LtGrimms (3378 in chips) 
Seat 8: Adios89 (2835 in chips) 
Seat 9: Liskacha (2810 in chips) is sitting out
rastamanooo: posts small blind 15
liamkid: posts big blind 30
*** HOLE CARDS ***
Dealt to LtGrimms [3s Tc]
R@nTAnpl@N: folds 
markxx311: folds 
mecco: folds 
LtGrimms: folds 
Adios89: raises 60 to 90
Liskacha: folds 
rastamanooo: folds 
liamkid: folds 
Uncalled bet (60) returned to Adios89
Adios89 collected 75 from pot
*** SUMMARY ***
Total pot 75 | Rake 0 
Seat 2: rastamanooo (small blind) folded before Flop
Seat 3: liamkid (big blind) folded before Flop
Seat 4: R@nTAnpl@N folded before Flop (didn't bet)
Seat 5: markxx311 folded before Flop (didn't bet)
Seat 6: mecco folded before Flop (didn't bet)
Seat 7: LtGrimms folded before Flop (didn't bet)
Seat 8: Adios89 collected (75)
Seat 9: Liskacha (button) folded before Flop (didn't bet)



PokerStars Hand #139418148881: Tournament #1292680929, $10+$1 USD Hold'em No Limit - Level II (15/30) - 2015/08/15 13:31:27 ET
Table '1292680929 17' 9-max Seat #2 is the button
Seat 1: gits1980 (3000 in chips) 
Seat 2: rastamanooo (2945 in chips) 
Seat 3: liamkid (2775 in chips) 
Seat 4: R@nTAnpl@N (3128 in chips) 
Seat 5: markxx311 (3099 in chips) 
Seat 6: mecco (2835 in chips) 
Seat 7: LtGrimms (3378 in chips) 
Seat 8: Adios89 (2880 in chips) 
Seat 9: Liskacha (2810 in chips) is sitting out
liamkid: posts small blind 15
R@nTAnpl@N: posts big blind 30
*** HOLE CARDS ***
Dealt to LtGrimms [3c As]
markxx311: folds 
mecco: folds 
LtGrimms: folds 
Adios89: raises 60 to 90
Liskacha: folds 
gits1980: folds 
rastamanooo: folds 
liamkid: calls 75
R@nTAnpl@N: folds 
*** FLOP *** [Qh 7h 6s]
liamkid: bets 126
Adios89: raises 221 to 347
liamkid: folds 
Uncalled bet (221) returned to Adios89
Adios89 collected 462 from pot
*** SUMMARY ***
Total pot 462 | Rake 0 
Board [Qh 7h 6s]
Seat 1: gits1980 folded before Flop (didn't bet)
Seat 2: rastamanooo (button) folded before Flop (didn't bet)
Seat 3: liamkid (small blind) folded on the Flop
Seat 4: R@nTAnpl@N (big blind) folded before Flop
Seat 5: markxx311 folded before Flop (didn't bet)
Seat 6: mecco folded before Flop (didn't bet)
Seat 7: LtGrimms folded before Flop (didn't bet)
Seat 8: Adios89 collected (462)
Seat 9: Liskacha folded before Flop (didn't bet)



PokerStars Hand #139418183931: Tournament #1292680929, $10+$1 USD Hold'em No Limit - Level II (15/30) - 2015/08/15 13:32:19 ET
Table '1292680929 17' 9-max Seat #3 is the button
Seat 1: gits1980 (3000 in chips) 
Seat 2: rastamanooo (2945 in chips) 
Seat 3: liamkid (2559 in chips) 
Seat 4: R@nTAnpl@N (3098 in chips) 
Seat 5: markxx311 (3099 in chips) 
Seat 6: mecco (2835 in chips) 
Seat 7: LtGrimms (3378 in chips) 
Seat 8: Adios89 (3126 in chips) 
Seat 9: Liskacha (2810 in chips) is sitting out
R@nTAnpl@N: posts small blind 15
markxx311: posts big blind 30
*** HOLE CARDS ***
Dealt to LtGrimms [3d Ks]
mecco: folds 
LtGrimms: folds 
Adios89: folds 
Liskacha: folds 
gits1980: folds 
rastamanooo: folds 
liamkid: folds 
R@nTAnpl@N: folds 
Uncalled bet (15) returned to markxx311
markxx311 collected 30 from pot
*** SUMMARY ***
Total pot 30 | Rake 0 
Seat 1: gits1980 folded before Flop (didn't bet)
Seat 2: rastamanooo folded before Flop (didn't bet)
Seat 3: liamkid (button) folded before Flop (didn't bet)
Seat 4: R@nTAnpl@N (small blind) folded before Flop
Seat 5: markxx311 (big blind) collected (30)
Seat 6: mecco folded before Flop (didn't bet)
Seat 7: LtGrimms folded before Flop (didn't bet)
Seat 8: Adios89 folded before Flop (didn't bet)
Seat 9: Liskacha folded before Flop (didn't bet)



PokerStars Hand #139418195190: Tournament #1292680929, $10+$1 USD Hold'em No Limit - Level II (15/30) - 2015/08/15 13:32:35 ET
Table '1292680929 17' 9-max Seat #4 is the button
Seat 1: gits1980 (3000 in chips) 
Seat 2: rastamanooo (2945 in chips) 
Seat 3: liamkid (2559 in chips) 
Seat 4: R@nTAnpl@N (3083 in chips) 
Seat 5: markxx311 (3114 in chips) 
Seat 6: mecco (2835 in chips) 
Seat 7: LtGrimms (3378 in chips) 
Seat 8: Adios89 (3126 in chips) 
Seat 9: Liskacha (2810 in chips) is sitting out
markxx311: posts small blind 15
mecco: posts big blind 30
*** HOLE CARDS ***
Dealt to LtGrimms [3c Kh]
LtGrimms: folds 
Adios89: folds 
Liskacha: folds 
gits1980: folds 
rastamanooo: folds 
Liskacha has returned
liamkid: folds 
R@nTAnpl@N: raises 32 to 62
markxx311: folds 
mecco: folds 
Uncalled bet (32) returned to R@nTAnpl@N
R@nTAnpl@N collected 75 from pot
*** SUMMARY ***
Total pot 75 | Rake 0 
Seat 1: gits1980 folded before Flop (didn't bet)
Seat 2: rastamanooo folded before Flop (didn't bet)
Seat 3: liamkid folded before Flop (didn't bet)
Seat 4: R@nTAnpl@N (button) collected (75)
Seat 5: markxx311 (small blind) folded before Flop
Seat 6: mecco (big blind) folded before Flop
Seat 7: LtGrimms folded before Flop (didn't bet)
Seat 8: Adios89 folded before Flop (didn't bet)
Seat 9: Liskacha folded before Flop (didn't bet)



PokerStars Hand #139418218926: Tournament #1292680929, $10+$1 USD Hold'em No Limit - Level II (15/30) - 2015/08/15 13:33:10 ET
Table '1292680929 17' 9-max Seat #5 is the button
Seat 1: gits1980 (3000 in chips) 
Seat 2: rastamanooo (2945 in chips) 
Seat 3: liamkid (2559 in chips) 
Seat 4: R@nTAnpl@N (3128 in chips) 
Seat 5: markxx311 (3099 in chips) 
Seat 6: mecco (2805 in chips) 
Seat 7: LtGrimms (3378 in chips) 
Seat 8: Adios89 (3126 in chips) 
Seat 9: Liskacha (2810 in chips) 
mecco: posts small blind 15
LtGrimms: posts big blind 30
*** HOLE CARDS ***
Dealt to LtGrimms [4s 6d]
Adios89: folds 
Liskacha: folds 
gits1980: folds 
rastamanooo: folds 
liamkid: folds 
R@nTAnpl@N: raises 32 to 62
markxx311: folds 
mecco: folds 
LtGrimms: calls 32
*** FLOP *** [3h 3s 4d]
LtGrimms: bets 80
R@nTAnpl@N: raises 100 to 180
LtGrimms: folds 
Uncalled bet (100) returned to R@nTAnpl@N
R@nTAnpl@N collected 299 from pot
*** SUMMARY ***
Total pot 299 | Rake 0 
Board [3h 3s 4d]
Seat 1: gits1980 folded before Flop (didn't bet)
Seat 2: rastamanooo folded before Flop (didn't bet)
Seat 3: liamkid folded before Flop (didn't bet)
Seat 4: R@nTAnpl@N collected (299)
Seat 5: markxx311 (button) folded before Flop (didn't bet)
Seat 6: mecco (small blind) folded before Flop
Seat 7: LtGrimms (big blind) folded on the Flop
Seat 8: Adios89 folded before Flop (didn't bet)
Seat 9: Liskacha folded before Flop (didn't bet)



PokerStars Hand #139418276694: Tournament #1292680929, $10+$1 USD Hold'em No Limit - Level II (15/30) - 2015/08/15 13:34:35 ET
Table '1292680929 17' 9-max Seat #6 is the button
Seat 1: gits1980 (3000 in chips) 
Seat 2: rastamanooo (2945 in chips) 
Seat 3: liamkid (2559 in chips) 
Seat 4: R@nTAnpl@N (3285 in chips) 
Seat 5: markxx311 (3099 in chips) 
Seat 6: mecco (2790 in chips) 
Seat 7: LtGrimms (3236 in chips) 
Seat 8: Adios89 (3126 in chips) 
Seat 9: Liskacha (2810 in chips) 
LtGrimms: posts small blind 15
Adios89: posts big blind 30
*** HOLE CARDS ***
Dealt to LtGrimms [Ac Th]
Liskacha: folds 
gits1980: folds 
rastamanooo: folds 
liamkid: folds 
R@nTAnpl@N: folds 
markxx311: folds 
mecco: folds 
LtGrimms: calls 15
Adios89: checks 
*** FLOP *** [6h Qs 2s]
LtGrimms: checks 
Adios89: checks 
*** TURN *** [6h Qs 2s] [3d]
LtGrimms: bets 30
Adios89: folds 
Uncalled bet (30) returned to LtGrimms
LtGrimms collected 60 from pot
*** SUMMARY ***
Total pot 60 | Rake 0 
Board [6h Qs 2s 3d]
Seat 1: gits1980 folded before Flop (didn't bet)
Seat 2: rastamanooo folded before Flop (didn't bet)
Seat 3: liamkid folded before Flop (didn't bet)
Seat 4: R@nTAnpl@N folded before Flop (didn't bet)
Seat 5: markxx311 folded before Flop (didn't bet)
Seat 6: mecco (button) folded before Flop (didn't bet)
Seat 7: LtGrimms (small blind) collected (60)
Seat 8: Adios89 (big blind) folded on the Turn
Seat 9: Liskacha folded before Flop (didn't bet)



PokerStars Hand #139418304114: Tournament #1292680929, $10+$1 USD Hold'em No Limit - Level II (15/30) - 2015/08/15 13:35:16 ET
Table '1292680929 17' 9-max Seat #7 is the button
Seat 1: gits1980 (3000 in chips) 
Seat 2: rastamanooo (2945 in chips) 
Seat 3: liamkid (2559 in chips) 
Seat 4: R@nTAnpl@N (3285 in chips) 
Seat 5: markxx311 (3099 in chips) 
Seat 6: mecco (2790 in chips) 
Seat 7: LtGrimms (3266 in chips) 
Seat 8: Adios89 (3096 in chips) 
Adios89: posts small blind 15
gits1980: posts big blind 30
*** HOLE CARDS ***
Dealt to LtGrimms [6h Qd]
rastamanooo: folds 
liamkid: folds 
R@nTAnpl@N: folds 
markxx311: raises 30 to 60
mecco: calls 60
LtGrimms: folds 
Adios89: folds 
gits1980: folds 
*** FLOP *** [4d 5d Js]
markxx311: bets 90
mecco: folds 
Uncalled bet (90) returned to markxx311
markxx311 collected 165 from pot
*** SUMMARY ***
Total pot 165 | Rake 0 
Board [4d 5d Js]
Seat 1: gits1980 (big blind) folded before Flop
Seat 2: rastamanooo folded before Flop (didn't bet)
Seat 3: liamkid folded before Flop (didn't bet)
Seat 4: R@nTAnpl@N folded before Flop (didn't bet)
Seat 5: markxx311 collected (165)
Seat 6: mecco folded on the Flop
Seat 7: LtGrimms (button) folded before Flop (didn't bet)
Seat 8: Adios89 (small blind) folded before Flop



PokerStars Hand #139418333201: Tournament #1292680929, $10+$1 USD Hold'em No Limit - Level III (20/40) - 2015/08/15 13:35:59 ET
Table '1292680929 17' 9-max Seat #8 is the button
Seat 1: gits1980 (2970 in chips) 
Seat 2: rastamanooo (2945 in chips) 
Seat 3: liamkid (2559 in chips) 
Seat 4: R@nTAnpl@N (3285 in chips) 
Seat 5: markxx311 (3204 in chips) 
Seat 6: mecco (2730 in chips) 
Seat 7: LtGrimms (3266 in chips) 
Seat 8: Adios89 (3081 in chips) 
Seat 9: kartrid (3000 in chips) out of hand (moved from another table into small blind)
gits1980: posts small blind 20
rastamanooo: posts big blind 40
*** HOLE CARDS ***
Dealt to LtGrimms [4d Ts]
liamkid: folds 
R@nTAnpl@N: folds 
markxx311: folds 
mecco: folds 
LtGrimms: folds 
Adios89: raises 40 to 80
gits1980: folds 
rastamanooo: folds 
Uncalled bet (40) returned to Adios89
Adios89 collected 100 from pot
*** SUMMARY ***
Total pot 100 | Rake 0 
Seat 1: gits1980 (small blind) folded before Flop
Seat 2: rastamanooo (big blind) folded before Flop
Seat 3: liamkid folded before Flop (didn't bet)
Seat 4: R@nTAnpl@N folded before Flop (didn't bet)
Seat 5: markxx311 folded before Flop (didn't bet)
Seat 6: mecco folded before Flop (didn't bet)
Seat 7: LtGrimms folded before Flop (didn't bet)
Seat 8: Adios89 (button) collected (100)



PokerStars Hand #139418355658: Tournament #1292680929, $10+$1 USD Hold'em No Limit - Level III (20/40) - 2015/08/15 13:36:32 ET
Table '1292680929 17' 9-max Seat #1 is the button
Seat 1: gits1980 (2950 in chips) 
Seat 2: rastamanooo (2905 in chips) 
Seat 3: liamkid (2559 in chips) 
Seat 4: R@nTAnpl@N (3285 in chips) 
Seat 5: markxx311 (3204 in chips) 
Seat 6: mecco (2730 in chips) 
Seat 7: LtGrimms (3266 in chips) 
Seat 8: Adios89 (3141 in chips) 
Seat 9: kartrid (3000 in chips) 
rastamanooo: posts small blind 20
liamkid: posts big blind 40
*** HOLE CARDS ***
Dealt to LtGrimms [5h 5d]
R@nTAnpl@N: folds 
markxx311: folds 
mecco: folds 
LtGrimms: raises 60 to 100
Adios89: folds 
kartrid: folds 
gits1980: folds 
rastamanooo: folds 
liamkid: folds 
Uncalled bet (60) returned to LtGrimms
LtGrimms collected 100 from pot
*** SUMMARY ***
Total pot 100 | Rake 0 
Seat 1: gits1980 (button) folded before Flop (didn't bet)
Seat 2: rastamanooo (small blind) folded before Flop
Seat 3: liamkid (big blind) folded before Flop
Seat 4: R@nTAnpl@N folded before Flop (didn't bet)
Seat 5: markxx311 folded before Flop (didn't bet)
Seat 6: mecco folded before Flop (didn't bet)
Seat 7: LtGrimms collected (100)
Seat 8: Adios89 folded before Flop (didn't bet)
Seat 9: kartrid folded before Flop (didn't bet)



PokerStars Hand #139418397055: Tournament #1292680929, $10+$1 USD Hold'em No Limit - Level III (20/40) - 2015/08/15 13:37:34 ET
Table '1292680929 17' 9-max Seat #2 is the button
Seat 1: gits1980 (2950 in chips) 
Seat 2: rastamanooo (2885 in chips) 
Seat 3: liamkid (2519 in chips) 
Seat 4: R@nTAnpl@N (3285 in chips) 
Seat 5: markxx311 (3204 in chips) 
Seat 6: mecco (2730 in chips) 
Seat 7: LtGrimms (3326 in chips) 
Seat 8: Adios89 (3141 in chips) 
Seat 9: kartrid (3000 in chips) 
liamkid: posts small blind 20
R@nTAnpl@N: posts big blind 40
*** HOLE CARDS ***
Dealt to LtGrimms [3d 5d]
markxx311: folds 
mecco: folds 
LtGrimms: folds 
Adios89: folds 
kartrid: folds 
gits1980: folds 
rastamanooo: folds 
liamkid: folds 
Uncalled bet (20) returned to R@nTAnpl@N
R@nTAnpl@N collected 40 from pot
*** SUMMARY ***
Total pot 40 | Rake 0 
Seat 1: gits1980 folded before Flop (didn't bet)
Seat 2: rastamanooo (button) folded before Flop (didn't bet)
Seat 3: liamkid (small blind) folded before Flop
Seat 4: R@nTAnpl@N (big blind) collected (40)
Seat 5: markxx311 folded before Flop (didn't bet)
Seat 6: mecco folded before Flop (didn't bet)
Seat 7: LtGrimms folded before Flop (didn't bet)
Seat 8: Adios89 folded before Flop (didn't bet)
Seat 9: kartrid folded before Flop (didn't bet)



PokerStars Hand #139418419406: Tournament #1292680929, $10+$1 USD Hold'em No Limit - Level III (20/40) - 2015/08/15 13:38:07 ET
Table '1292680929 17' 9-max Seat #3 is the button
Seat 1: gits1980 (2950 in chips) 
Seat 2: rastamanooo (2885 in chips) 
Seat 3: liamkid (2499 in chips) 
Seat 4: R@nTAnpl@N (3305 in chips) 
Seat 5: markxx311 (3204 in chips) 
Seat 6: mecco (2730 in chips) 
Seat 7: LtGrimms (3326 in chips) 
Seat 8: Adios89 (3141 in chips) 
Seat 9: kartrid (3000 in chips) 
R@nTAnpl@N: posts small blind 20
markxx311: posts big blind 40
*** HOLE CARDS ***
Dealt to LtGrimms [6s 8c]
mecco: folds 
LtGrimms: folds 
Adios89: folds 
kartrid: folds 
gits1980: folds 
rastamanooo: folds 
liamkid: folds 
R@nTAnpl@N: folds 
Uncalled bet (20) returned to markxx311
markxx311 collected 40 from pot
*** SUMMARY ***
Total pot 40 | Rake 0 
Seat 1: gits1980 folded before Flop (didn't bet)
Seat 2: rastamanooo folded before Flop (didn't bet)
Seat 3: liamkid (button) folded before Flop (didn't bet)
Seat 4: R@nTAnpl@N (small blind) folded before Flop
Seat 5: markxx311 (big blind) collected (40)
Seat 6: mecco folded before Flop (didn't bet)
Seat 7: LtGrimms folded before Flop (didn't bet)
Seat 8: Adios89 folded before Flop (didn't bet)
Seat 9: kartrid folded before Flop (didn't bet)



PokerStars Hand #139418442344: Tournament #1292680929, $10+$1 USD Hold'em No Limit - Level III (20/40) - 2015/08/15 13:38:42 ET
Table '1292680929 17' 9-max Seat #4 is the button
Seat 1: gits1980 (2950 in chips) 
Seat 2: rastamanooo (2885 in chips) 
Seat 3: liamkid (2499 in chips) 
Seat 4: R@nTAnpl@N (3285 in chips) 
Seat 5: markxx311 (3224 in chips) 
Seat 6: mecco (2730 in chips) 
Seat 7: LtGrimms (3326 in chips) 
Seat 8: Adios89 (3141 in chips) 
Seat 9: kartrid (3000 in chips) 
markxx311: posts small blind 20
mecco: posts big blind 40
*** HOLE CARDS ***
Dealt to LtGrimms [6d Ah]
LtGrimms: folds 
Adios89: folds 
kartrid: folds 
gits1980: folds 
rastamanooo: folds 
liamkid: folds 
R@nTAnpl@N: raises 43 to 83
markxx311: calls 63
mecco: folds 
*** FLOP *** [2s Jc 7h]
markxx311: checks 
R@nTAnpl@N: bets 105
markxx311: calls 105
*** TURN *** [2s Jc 7h] [3d]
markxx311: bets 208
R@nTAnpl@N: folds 
Uncalled bet (208) returned to markxx311
markxx311 collected 416 from pot
*** SUMMARY ***
Total pot 416 | Rake 0 
Board [2s Jc 7h 3d]
Seat 1: gits1980 folded before Flop (didn't bet)
Seat 2: rastamanooo folded before Flop (didn't bet)
Seat 3: liamkid folded before Flop (didn't bet)
Seat 4: R@nTAnpl@N (button) folded on the Turn
Seat 5: markxx311 (small blind) collected (416)
Seat 6: mecco (big blind) folded before Flop
Seat 7: LtGrimms folded before Flop (didn't bet)
Seat 8: Adios89 folded before Flop (didn't bet)
Seat 9: kartrid folded before Flop (didn't bet)



PokerStars Hand #139418492382: Tournament #1292680929, $10+$1 USD Hold'em No Limit - Level III (20/40) - 2015/08/15 13:39:57 ET
Table '1292680929 17' 9-max Seat #5 is the button
Seat 1: gits1980 (2950 in chips) 
Seat 2: rastamanooo (2885 in chips) 
Seat 3: liamkid (2499 in chips) 
Seat 4: R@nTAnpl@N (3097 in chips) 
Seat 5: markxx311 (3452 in chips) 
Seat 6: mecco (2690 in chips) 
Seat 7: LtGrimms (3326 in chips) 
Seat 8: Adios89 (3141 in chips) 
Seat 9: kartrid (3000 in chips) 
mecco: posts small blind 20
LtGrimms: posts big blind 40
*** HOLE CARDS ***
Dealt to LtGrimms [8h Ac]
Adios89: folds 
kartrid: folds 
gits1980: folds 
rastamanooo: folds 
liamkid: folds 
R@nTAnpl@N: folds 
markxx311: folds 
mecco: raises 80 to 120
LtGrimms: calls 80
*** FLOP *** [2s 2c Js]
mecco: checks 
LtGrimms: checks 
*** TURN *** [2s 2c Js] [Kd]
mecco: bets 120
LtGrimms: folds 
Uncalled bet (120) returned to mecco
mecco collected 240 from pot
mecco: doesn't show hand 
*** SUMMARY ***
Total pot 240 | Rake 0 
Board [2s 2c Js Kd]
Seat 1: gits1980 folded before Flop (didn't bet)
Seat 2: rastamanooo folded before Flop (didn't bet)
Seat 3: liamkid folded before Flop (didn't bet)
Seat 4: R@nTAnpl@N folded before Flop (didn't bet)
Seat 5: markxx311 (button) folded before Flop (didn't bet)
Seat 6: mecco (small blind) collected (240)
Seat 7: LtGrimms (big blind) folded on the Turn
Seat 8: Adios89 folded before Flop (didn't bet)
Seat 9: kartrid folded before Flop (didn't bet)



PokerStars Hand #139418521080: Tournament #1292680929, $10+$1 USD Hold'em No Limit - Level III (20/40) - 2015/08/15 13:40:40 ET
Table '1292680929 17' 9-max Seat #6 is the button
Seat 1: gits1980 (2950 in chips) 
Seat 2: rastamanooo (2885 in chips) 
Seat 3: liamkid (2499 in chips) 
Seat 4: R@nTAnpl@N (3097 in chips) 
Seat 5: markxx311 (3452 in chips) 
Seat 6: mecco (2810 in chips) 
Seat 7: LtGrimms (3206 in chips) 
Seat 8: Adios89 (3141 in chips) 
Seat 9: kartrid (3000 in chips) 
LtGrimms: posts small blind 20
Adios89: posts big blind 40
*** HOLE CARDS ***
Dealt to LtGrimms [Ah Js]
kartrid: folds 
gits1980: folds 
rastamanooo: folds 
liamkid: folds 
R@nTAnpl@N: folds 
markxx311: raises 40 to 80
mecco: raises 160 to 240
LtGrimms: folds 
Adios89: folds 
markxx311: folds 
Uncalled bet (160) returned to mecco
mecco collected 220 from pot
mecco: doesn't show hand 
*** SUMMARY ***
Total pot 220 | Rake 0 
Seat 1: gits1980 folded before Flop (didn't bet)
Seat 2: rastamanooo folded before Flop (didn't bet)
Seat 3: liamkid folded before Flop (didn't bet)
Seat 4: R@nTAnpl@N folded before Flop (didn't bet)
Seat 5: markxx311 folded before Flop
Seat 6: mecco (button) collected (220)
Seat 7: LtGrimms (small blind) folded before Flop
Seat 8: Adios89 (big blind) folded before Flop
Seat 9: kartrid folded before Flop (didn't bet)



PokerStars Hand #139418551526: Tournament #1292680929, $10+$1 USD Hold'em No Limit - Level III (20/40) - 2015/08/15 13:41:25 ET
Table '1292680929 17' 9-max Seat #7 is the button
Seat 1: gits1980 (2950 in chips) 
Seat 2: rastamanooo (2885 in chips) 
Seat 3: liamkid (2499 in chips) 
Seat 4: R@nTAnpl@N (3097 in chips) 
Seat 5: markxx311 (3372 in chips) 
Seat 6: mecco (2950 in chips) 
Seat 7: LtGrimms (3186 in chips) 
Seat 8: Adios89 (3101 in chips) 
Seat 9: kartrid (3000 in chips) 
Adios89: posts small blind 20
kartrid: posts big blind 40
*** HOLE CARDS ***
Dealt to LtGrimms [Jh Kd]
gits1980: folds 
rastamanooo: folds 
liamkid: folds 
R@nTAnpl@N: folds 
markxx311: folds 
mecco: folds 
LtGrimms: raises 60 to 100
Adios89: folds 
kartrid: folds 
Uncalled bet (60) returned to LtGrimms
LtGrimms collected 100 from pot
*** SUMMARY ***
Total pot 100 | Rake 0 
Seat 1: gits1980 folded before Flop (didn't bet)
Seat 2: rastamanooo folded before Flop (didn't bet)
Seat 3: liamkid folded before Flop (didn't bet)
Seat 4: R@nTAnpl@N folded before Flop (didn't bet)
Seat 5: markxx311 folded before Flop (didn't bet)
Seat 6: mecco folded before Flop (didn't bet)
Seat 7: LtGrimms (button) collected (100)
Seat 8: Adios89 (small blind) folded before Flop
Seat 9: kartrid (big blind) folded before Flop



PokerStars Hand #139418567245: Tournament #1292680929, $10+$1 USD Hold'em No Limit - Level III (20/40) - 2015/08/15 13:41:49 ET
Table '1292680929 17' 9-max Seat #8 is the button
Seat 1: gits1980 (2950 in chips) 
Seat 2: rastamanooo (2885 in chips) 
Seat 3: liamkid (2499 in chips) 
Seat 4: R@nTAnpl@N (3097 in chips) 
Seat 5: markxx311 (3372 in chips) 
Seat 6: mecco (2950 in chips) 
Seat 7: LtGrimms (3246 in chips) 
Seat 8: Adios89 (3081 in chips) 
Seat 9: kartrid (2960 in chips) 
kartrid: posts small blind 20
gits1980: posts big blind 40
*** HOLE CARDS ***
Dealt to LtGrimms [Ts 7d]
rastamanooo: folds 
liamkid: folds 
R@nTAnpl@N: folds 
markxx311: folds 
mecco: folds 
LtGrimms: folds 
Adios89: folds 
kartrid: folds 
Uncalled bet (20) returned to gits1980
gits1980 collected 40 from pot
gits1980: doesn't show hand 
*** SUMMARY ***
Total pot 40 | Rake 0 
Seat 1: gits1980 (big blind) collected (40)
Seat 2: rastamanooo folded before Flop (didn't bet)
Seat 3: liamkid folded before Flop (didn't bet)
Seat 4: R@nTAnpl@N folded before Flop (didn't bet)
Seat 5: markxx311 folded before Flop (didn't bet)
Seat 6: mecco folded before Flop (didn't bet)
Seat 7: LtGrimms folded before Flop (didn't bet)
Seat 8: Adios89 (button) folded before Flop (didn't bet)
Seat 9: kartrid (small blind) folded before Flop



PokerStars Hand #139418584303: Tournament #1292680929, $10+$1 USD Hold'em No Limit - Level III (20/40) - 2015/08/15 13:42:14 ET
Table '1292680929 17' 9-max Seat #9 is the button
Seat 1: gits1980 (2970 in chips) 
Seat 2: rastamanooo (2885 in chips) 
Seat 3: liamkid (2499 in chips) 
Seat 4: R@nTAnpl@N (3097 in chips) 
Seat 5: markxx311 (3372 in chips) 
Seat 6: mecco (2950 in chips) 
Seat 7: LtGrimms (3246 in chips) 
Seat 8: Adios89 (3081 in chips) 
Seat 9: kartrid (2940 in chips) 
gits1980: posts small blind 20
rastamanooo: posts big blind 40
*** HOLE CARDS ***
Dealt to LtGrimms [Jh Td]
liamkid: folds 
R@nTAnpl@N: folds 
markxx311: folds 
mecco: folds 
LtGrimms: raises 60 to 100
Adios89: folds 
kartrid: folds 
gits1980: folds 
rastamanooo: folds 
Uncalled bet (60) returned to LtGrimms
LtGrimms collected 100 from pot
*** SUMMARY ***
Total pot 100 | Rake 0 
Seat 1: gits1980 (small blind) folded before Flop
Seat 2: rastamanooo (big blind) folded before Flop
Seat 3: liamkid folded before Flop (didn't bet)
Seat 4: R@nTAnpl@N folded before Flop (didn't bet)
Seat 5: markxx311 folded before Flop (didn't bet)
Seat 6: mecco folded before Flop (didn't bet)
Seat 7: LtGrimms collected (100)
Seat 8: Adios89 folded before Flop (didn't bet)
Seat 9: kartrid (button) folded before Flop (didn't bet)



PokerStars Hand #139418612749: Tournament #1292680929, $10+$1 USD Hold'em No Limit - Level III (20/40) - 2015/08/15 13:42:57 ET
Table '1292680929 17' 9-max Seat #1 is the button
Seat 1: gits1980 (2950 in chips) 
Seat 2: rastamanooo (2845 in chips) 
Seat 3: liamkid (2499 in chips) 
Seat 4: R@nTAnpl@N (3097 in chips) 
Seat 5: markxx311 (3372 in chips) 
Seat 6: mecco (2950 in chips) 
Seat 7: LtGrimms (3306 in chips) 
Seat 8: Adios89 (3081 in chips) 
Seat 9: kartrid (2940 in chips) 
rastamanooo: posts small blind 20
liamkid: posts big blind 40
*** HOLE CARDS ***
Dealt to LtGrimms [Ks 5h]
R@nTAnpl@N: raises 80 to 120
markxx311: folds 
mecco: folds 
LtGrimms: folds 
Adios89: folds 
kartrid: folds 
gits1980: folds 
rastamanooo: folds 
liamkid: folds 
Uncalled bet (80) returned to R@nTAnpl@N
R@nTAnpl@N collected 100 from pot
*** SUMMARY ***
Total pot 100 | Rake 0 
Seat 1: gits1980 (button) folded before Flop (didn't bet)
Seat 2: rastamanooo (small blind) folded before Flop
Seat 3: liamkid (big blind) folded before Flop
Seat 4: R@nTAnpl@N collected (100)
Seat 5: markxx311 folded before Flop (didn't bet)
Seat 6: mecco folded before Flop (didn't bet)
Seat 7: LtGrimms folded before Flop (didn't bet)
Seat 8: Adios89 folded before Flop (didn't bet)
Seat 9: kartrid folded before Flop (didn't bet)



PokerStars Hand #139418642954: Tournament #1292680929, $10+$1 USD Hold'em No Limit - Level III (20/40) - 2015/08/15 13:43:43 ET
Table '1292680929 17' 9-max Seat #2 is the button
Seat 1: gits1980 (2950 in chips) 
Seat 2: rastamanooo (2825 in chips) 
Seat 3: liamkid (2459 in chips) 
Seat 4: R@nTAnpl@N (3157 in chips) 
Seat 5: markxx311 (3372 in chips) 
Seat 6: mecco (2950 in chips) 
Seat 7: LtGrimms (3306 in chips) 
Seat 8: Adios89 (3081 in chips) 
Seat 9: kartrid (2940 in chips) 
liamkid: posts small blind 20
R@nTAnpl@N: posts big blind 40
*** HOLE CARDS ***
Dealt to LtGrimms [5d Js]
markxx311: folds 
mecco: folds 
LtGrimms: folds 
Adios89: folds 
kartrid: folds 
gits1980: calls 40
rastamanooo: raises 120 to 160
liamkid: folds 
R@nTAnpl@N: folds 
gits1980: raises 2790 to 2950 and is all-in
rastamanooo: folds 
Uncalled bet (2790) returned to gits1980
gits1980 collected 380 from pot
gits1980: doesn't show hand 
*** SUMMARY ***
Total pot 380 | Rake 0 
Seat 1: gits1980 collected (380)
Seat 2: rastamanooo (button) folded before Flop
Seat 3: liamkid (small blind) folded before Flop
Seat 4: R@nTAnpl@N (big blind) folded before Flop
Seat 5: markxx311 folded before Flop (didn't bet)
Seat 6: mecco folded before Flop (didn't bet)
Seat 7: LtGrimms folded before Flop (didn't bet)
Seat 8: Adios89 folded before Flop (didn't bet)
Seat 9: kartrid folded before Flop (didn't bet)



PokerStars Hand #139418677469: Tournament #1292680929, $10+$1 USD Hold'em No Limit - Level III (20/40) - 2015/08/15 13:44:34 ET
Table '1292680929 17' 9-max Seat #3 is the button
Seat 1: gits1980 (3170 in chips) 
Seat 2: rastamanooo (2665 in chips) 
Seat 3: liamkid (2439 in chips) 
Seat 4: R@nTAnpl@N (3117 in chips) 
Seat 6: mecco (2950 in chips) 
Seat 7: LtGrimms (3306 in chips) 
Seat 8: Adios89 (3081 in chips) 
Seat 9: kartrid (2940 in chips) 
R@nTAnpl@N: posts small blind 20
mecco: posts big blind 40
*** HOLE CARDS ***
Dealt to LtGrimms [8s Ah]
LtGrimms: folds 
Adios89: folds 
kartrid: folds 
gits1980: folds 
rastamanooo: folds 
liamkid: folds 
R@nTAnpl@N: folds 
Uncalled bet (20) returned to mecco
mecco collected 40 from pot
mecco: doesn't show hand 
*** SUMMARY ***
Total pot 40 | Rake 0 
Seat 1: gits1980 folded before Flop (didn't bet)
Seat 2: rastamanooo folded before Flop (didn't bet)
Seat 3: liamkid (button) folded before Flop (didn't bet)
Seat 4: R@nTAnpl@N (small blind) folded before Flop
Seat 6: mecco (big blind) collected (40)
Seat 7: LtGrimms folded before Flop (didn't bet)
Seat 8: Adios89 folded before Flop (didn't bet)
Seat 9: kartrid folded before Flop (didn't bet)



PokerStars Hand #139418697898: Tournament #1292680929, $10+$1 USD Hold'em No Limit - Level III (20/40) - 2015/08/15 13:45:04 ET
Table '1292680929 17' 9-max Seat #4 is the button
Seat 1: gits1980 (3170 in chips) 
Seat 2: rastamanooo (2665 in chips) 
Seat 3: liamkid (2439 in chips) 
Seat 4: R@nTAnpl@N (3097 in chips) 
Seat 5: Fakhish (3000 in chips) out of hand (moved from another table into small blind)
Seat 6: mecco (2970 in chips) 
Seat 7: LtGrimms (3306 in chips) 
Seat 8: Adios89 (3081 in chips) 
Seat 9: kartrid (2940 in chips) 
mecco: posts small blind 20
LtGrimms: posts big blind 40
*** HOLE CARDS ***
Dealt to LtGrimms [Ac Jc]
Adios89: folds 
kartrid: folds 
gits1980: folds 
rastamanooo: folds 
liamkid: folds 
R@nTAnpl@N: folds 
mecco: folds 
Uncalled bet (20) returned to LtGrimms
LtGrimms collected 40 from pot
*** SUMMARY ***
Total pot 40 | Rake 0 
Seat 1: gits1980 folded before Flop (didn't bet)
Seat 2: rastamanooo folded before Flop (didn't bet)
Seat 3: liamkid folded before Flop (didn't bet)
Seat 4: R@nTAnpl@N (button) folded before Flop (didn't bet)
Seat 6: mecco (small blind) folded before Flop
Seat 7: LtGrimms (big blind) collected (40)
Seat 8: Adios89 folded before Flop (didn't bet)
Seat 9: kartrid folded before Flop (didn't bet)



PokerStars Hand #139418730840: Tournament #1292680929, $10+$1 USD Hold'em No Limit - Level IV (25/50) - 2015/08/15 13:45:53 ET
Table '1292680929 17' 9-max Seat #6 is the button
Seat 1: gits1980 (3170 in chips) 
Seat 2: rastamanooo (2665 in chips) 
Seat 3: liamkid (2439 in chips) 
Seat 4: R@nTAnpl@N (3097 in chips) 
Seat 5: Fakhish (3000 in chips) 
Seat 6: mecco (2950 in chips) 
Seat 7: LtGrimms (3326 in chips) 
Seat 8: Adios89 (3081 in chips) 
Seat 9: kartrid (2940 in chips) 
LtGrimms: posts small blind 25
Adios89: posts big blind 50
*** HOLE CARDS ***
Dealt to LtGrimms [Ah Kc]
kartrid: folds 
gits1980: calls 50
rastamanooo: folds 
liamkid: folds 
R@nTAnpl@N: folds 
Fakhish: folds 
mecco: folds 
LtGrimms: raises 150 to 200
Adios89: folds 
gits1980: folds 
Uncalled bet (150) returned to LtGrimms
LtGrimms collected 150 from pot
*** SUMMARY ***
Total pot 150 | Rake 0 
Seat 1: gits1980 folded before Flop
Seat 2: rastamanooo folded before Flop (didn't bet)
Seat 3: liamkid folded before Flop (didn't bet)
Seat 4: R@nTAnpl@N folded before Flop (didn't bet)
Seat 5: Fakhish folded before Flop (didn't bet)
Seat 6: mecco (button) folded before Flop (didn't bet)
Seat 7: LtGrimms (small blind) collected (150)
Seat 8: Adios89 (big blind) folded before Flop
Seat 9: kartrid folded before Flop (didn't bet)



PokerStars Hand #139418760000: Tournament #1292680929, $10+$1 USD Hold'em No Limit - Level IV (25/50) - 2015/08/15 13:46:35 ET
Table '1292680929 17' 9-max Seat #7 is the button
Seat 1: gits1980 (3120 in chips) 
Seat 2: rastamanooo (2665 in chips) 
Seat 3: liamkid (2439 in chips) 
Seat 4: R@nTAnpl@N (3097 in chips) 
Seat 5: Fakhish (3000 in chips) 
Seat 6: mecco (2950 in chips) 
Seat 7: LtGrimms (3426 in chips) 
Seat 8: Adios89 (3031 in chips) 
Seat 9: kartrid (2940 in chips) 
Adios89: posts small blind 25
kartrid: posts big blind 50
*** HOLE CARDS ***
Dealt to LtGrimms [9s Ks]
gits1980: folds 
rastamanooo: folds 
liamkid: raises 75 to 125
R@nTAnpl@N: folds 
Fakhish: folds 
mecco: calls 125
LtGrimms: calls 125
Adios89: folds 
kartrid: folds 
*** FLOP *** [Kd 4h 8c]
liamkid: bets 225
mecco: folds 
LtGrimms: folds 
Uncalled bet (225) returned to liamkid
liamkid collected 450 from pot
liamkid: doesn't show hand 
*** SUMMARY ***
Total pot 450 | Rake 0 
Board [Kd 4h 8c]
Seat 1: gits1980 folded before Flop (didn't bet)
Seat 2: rastamanooo folded before Flop (didn't bet)
Seat 3: liamkid collected (450)
Seat 4: R@nTAnpl@N folded before Flop (didn't bet)
Seat 5: Fakhish folded before Flop (didn't bet)
Seat 6: mecco folded on the Flop
Seat 7: LtGrimms (button) folded on the Flop
Seat 8: Adios89 (small blind) folded before Flop
Seat 9: kartrid (big blind) folded before Flop



PokerStars Hand #139418799417: Tournament #1292680929, $10+$1 USD Hold'em No Limit - Level IV (25/50) - 2015/08/15 13:47:34 ET
Table '1292680929 17' 9-max Seat #8 is the button
Seat 1: gits1980 (3120 in chips) 
Seat 2: rastamanooo (2665 in chips) 
Seat 3: liamkid (2764 in chips) 
Seat 4: R@nTAnpl@N (3097 in chips) 
Seat 5: Fakhish (3000 in chips) 
Seat 6: mecco (2825 in chips) 
Seat 7: LtGrimms (3301 in chips) 
Seat 8: Adios89 (3006 in chips) 
Seat 9: kartrid (2890 in chips) 
kartrid: posts small blind 25
gits1980: posts big blind 50
*** HOLE CARDS ***
Dealt to LtGrimms [Qc 6h]
rastamanooo: folds 
liamkid: folds 
R@nTAnpl@N: raises 100 to 150
Fakhish: folds 
mecco: folds 
LtGrimms: folds 
Adios89: calls 150
kartrid: folds 
gits1980: folds 
*** FLOP *** [8h 7s 5c]
R@nTAnpl@N: bets 247
Adios89: calls 247
*** TURN *** [8h 7s 5c] [9h]
R@nTAnpl@N: checks 
Adios89: checks 
*** RIVER *** [8h 7s 5c 9h] [3s]
R@nTAnpl@N: bets 278
Adios89: raises 684 to 962
R@nTAnpl@N: folds 
Uncalled bet (684) returned to Adios89
Adios89 collected 1425 from pot
*** SUMMARY ***
Total pot 1425 | Rake 0 
Board [8h 7s 5c 9h 3s]
Seat 1: gits1980 (big blind) folded before Flop
Seat 2: rastamanooo folded before Flop (didn't bet)
Seat 3: liamkid folded before Flop (didn't bet)
Seat 4: R@nTAnpl@N folded on the River
Seat 5: Fakhish folded before Flop (didn't bet)
Seat 6: mecco folded before Flop (didn't bet)
Seat 7: LtGrimms folded before Flop (didn't bet)
Seat 8: Adios89 (button) collected (1425)
Seat 9: kartrid (small blind) folded before Flop



PokerStars Hand #139418874562: Tournament #1292680929, $10+$1 USD Hold'em No Limit - Level IV (25/50) - 2015/08/15 13:49:25 ET
Table '1292680929 17' 9-max Seat #9 is the button
Seat 1: gits1980 (3070 in chips) 
Seat 2: rastamanooo (2665 in chips) 
Seat 3: liamkid (2764 in chips) 
Seat 4: R@nTAnpl@N (2422 in chips) 
Seat 5: Fakhish (3000 in chips) 
Seat 6: mecco (2825 in chips) 
Seat 7: LtGrimms (3301 in chips) 
Seat 8: Adios89 (3756 in chips) 
Seat 9: kartrid (2865 in chips) 
gits1980: posts small blind 25
rastamanooo: posts big blind 50
*** HOLE CARDS ***
Dealt to LtGrimms [Jc 7c]
liamkid: folds 
R@nTAnpl@N: folds 
Fakhish: folds 
mecco: calls 50
LtGrimms: folds 
Adios89: raises 100 to 150
kartrid: calls 150
gits1980: folds 
rastamanooo: folds 
mecco: calls 100
*** FLOP *** [7h 3c 9d]
mecco: checks 
Adios89: checks 
kartrid: bets 194
mecco: calls 194
Adios89: folds 
*** TURN *** [7h 3c 9d] [8d]
mecco: checks 
kartrid: checks 
*** RIVER *** [7h 3c 9d 8d] [Qh]
mecco: checks 
kartrid: checks 
*** SHOW DOWN ***
mecco: shows [7s 6s] (a pair of Sevens)
kartrid: mucks hand 
mecco collected 913 from pot
*** SUMMARY ***
Total pot 913 | Rake 0 
Board [7h 3c 9d 8d Qh]
Seat 1: gits1980 (small blind) folded before Flop
Seat 2: rastamanooo (big blind) folded before Flop
Seat 3: liamkid folded before Flop (didn't bet)
Seat 4: R@nTAnpl@N folded before Flop (didn't bet)
Seat 5: Fakhish folded before Flop (didn't bet)
Seat 6: mecco showed [7s 6s] and won (913) with a pair of Sevens
Seat 7: LtGrimms folded before Flop (didn't bet)
Seat 8: Adios89 folded on the Flop
Seat 9: kartrid (button) mucked [6c 6d]



PokerStars Hand #139418927654: Tournament #1292680929, $10+$1 USD Hold'em No Limit - Level IV (25/50) - 2015/08/15 13:50:45 ET
Table '1292680929 17' 9-max Seat #1 is the button
Seat 1: gits1980 (3045 in chips) 
Seat 2: rastamanooo (2615 in chips) 
Seat 3: liamkid (2764 in chips) 
Seat 4: R@nTAnpl@N (2422 in chips) 
Seat 5: Fakhish (3000 in chips) 
Seat 6: mecco (3394 in chips) 
Seat 7: LtGrimms (3301 in chips) 
Seat 8: Adios89 (3606 in chips) 
Seat 9: kartrid (2521 in chips) 
rastamanooo: posts small blind 25
liamkid: posts big blind 50
*** HOLE CARDS ***
Dealt to LtGrimms [Ah 7d]
R@nTAnpl@N: folds 
Fakhish: folds 
mecco: folds 
LtGrimms: raises 75 to 125
Adios89: folds 
kartrid: folds 
gits1980: folds 
rastamanooo: folds 
liamkid: raises 275 to 400
LtGrimms: calls 275
*** FLOP *** [As 9d 7s]
liamkid: bets 400
LtGrimms: raises 800 to 1200
liamkid: folds 
Uncalled bet (800) returned to LtGrimms
LtGrimms collected 1625 from pot
*** SUMMARY ***
Total pot 1625 | Rake 0 
Board [As 9d 7s]
Seat 1: gits1980 (button) folded before Flop (didn't bet)
Seat 2: rastamanooo (small blind) folded before Flop
Seat 3: liamkid (big blind) folded on the Flop
Seat 4: R@nTAnpl@N folded before Flop (didn't bet)
Seat 5: Fakhish folded before Flop (didn't bet)
Seat 6: mecco folded before Flop (didn't bet)
Seat 7: LtGrimms collected (1625)
Seat 8: Adios89 folded before Flop (didn't bet)
Seat 9: kartrid folded before Flop (didn't bet)



PokerStars Hand #139418991930: Tournament #1292680929, $10+$1 USD Hold'em No Limit - Level IV (25/50) - 2015/08/15 13:52:21 ET
Table '1292680929 17' 9-max Seat #2 is the button
Seat 1: gits1980 (3045 in chips) 
Seat 2: rastamanooo (2590 in chips) 
Seat 3: liamkid (1964 in chips) 
Seat 4: R@nTAnpl@N (2422 in chips) 
Seat 5: Fakhish (3000 in chips) 
Seat 6: mecco (3394 in chips) 
Seat 7: LtGrimms (4126 in chips) 
Seat 8: Adios89 (3606 in chips) 
Seat 9: kartrid (2521 in chips) 
liamkid: posts small blind 25
R@nTAnpl@N: posts big blind 50
*** HOLE CARDS ***
Dealt to LtGrimms [2c Qc]
Fakhish: folds 
mecco: folds 
LtGrimms: folds 
Adios89: folds 
kartrid: folds 
gits1980: folds 
rastamanooo: folds 
liamkid: folds 
Uncalled bet (25) returned to R@nTAnpl@N
R@nTAnpl@N collected 50 from pot
*** SUMMARY ***
Total pot 50 | Rake 0 
Seat 1: gits1980 folded before Flop (didn't bet)
Seat 2: rastamanooo (button) folded before Flop (didn't bet)
Seat 3: liamkid (small blind) folded before Flop
Seat 4: R@nTAnpl@N (big blind) collected (50)
Seat 5: Fakhish folded before Flop (didn't bet)
Seat 6: mecco folded before Flop (didn't bet)
Seat 7: LtGrimms folded before Flop (didn't bet)
Seat 8: Adios89 folded before Flop (didn't bet)
Seat 9: kartrid folded before Flop (didn't bet)



PokerStars Hand #139419018762: Tournament #1292680929, $10+$1 USD Hold'em No Limit - Level IV (25/50) - 2015/08/15 13:53:01 ET
Table '1292680929 17' 9-max Seat #3 is the button
Seat 1: gits1980 (3045 in chips) 
Seat 2: rastamanooo (2590 in chips) 
Seat 3: liamkid (1939 in chips) 
Seat 4: R@nTAnpl@N (2447 in chips) 
Seat 5: Fakhish (3000 in chips) 
Seat 6: mecco (3394 in chips) 
Seat 7: LtGrimms (4126 in chips) 
Seat 8: Adios89 (3606 in chips) 
Seat 9: kartrid (2521 in chips) 
R@nTAnpl@N: posts small blind 25
Fakhish: posts big blind 50
*** HOLE CARDS ***
Dealt to LtGrimms [4d Qd]
mecco: folds 
LtGrimms: folds 
Adios89: raises 75 to 125
kartrid: folds 
gits1980: folds 
rastamanooo: folds 
liamkid: folds 
R@nTAnpl@N: folds 
Fakhish: folds 
Uncalled bet (75) returned to Adios89
Adios89 collected 125 from pot
*** SUMMARY ***
Total pot 125 | Rake 0 
Seat 1: gits1980 folded before Flop (didn't bet)
Seat 2: rastamanooo folded before Flop (didn't bet)
Seat 3: liamkid (button) folded before Flop (didn't bet)
Seat 4: R@nTAnpl@N (small blind) folded before Flop
Seat 5: Fakhish (big blind) folded before Flop
Seat 6: mecco folded before Flop (didn't bet)
Seat 7: LtGrimms folded before Flop (didn't bet)
Seat 8: Adios89 collected (125)
Seat 9: kartrid folded before Flop (didn't bet)



PokerStars Hand #139419052315: Tournament #1292680929, $10+$1 USD Hold'em No Limit - Level IV (25/50) - 2015/08/15 13:53:52 ET
Table '1292680929 17' 9-max Seat #4 is the button
Seat 1: gits1980 (3045 in chips) 
Seat 2: rastamanooo (2590 in chips) 
Seat 3: liamkid (1939 in chips) 
Seat 4: R@nTAnpl@N (2422 in chips) 
Seat 5: Fakhish (2950 in chips) 
Seat 6: mecco (3394 in chips) 
Seat 7: LtGrimms (4126 in chips) 
Seat 8: Adios89 (3681 in chips) 
Seat 9: kartrid (2521 in chips) 
Fakhish: posts small blind 25
mecco: posts big blind 50
*** HOLE CARDS ***
Dealt to LtGrimms [2h 2s]
LtGrimms: folds 
Adios89: folds 
kartrid: folds 
gits1980: folds 
rastamanooo: folds 
liamkid: folds 
R@nTAnpl@N: folds 
Fakhish: raises 50 to 100
mecco: folds 
Uncalled bet (50) returned to Fakhish
Fakhish collected 100 from pot
*** SUMMARY ***
Total pot 100 | Rake 0 
Seat 1: gits1980 folded before Flop (didn't bet)
Seat 2: rastamanooo folded before Flop (didn't bet)
Seat 3: liamkid folded before Flop (didn't bet)
Seat 4: R@nTAnpl@N (button) folded before Flop (didn't bet)
Seat 5: Fakhish (small blind) collected (100)
Seat 6: mecco (big blind) folded before Flop
Seat 7: LtGrimms folded before Flop (didn't bet)
Seat 8: Adios89 folded before Flop (didn't bet)
Seat 9: kartrid folded before Flop (didn't bet)



PokerStars Hand #139419090945: Tournament #1292680929, $10+$1 USD Hold'em No Limit - Level IV (25/50) - 2015/08/15 13:54:50 ET
Table '1292680929 17' 9-max Seat #5 is the button
Seat 1: gits1980 (3045 in chips) 
Seat 2: rastamanooo (2590 in chips) 
Seat 3: liamkid (1939 in chips) 
Seat 4: R@nTAnpl@N (2422 in chips) 
Seat 5: Fakhish (3000 in chips) 
Seat 6: mecco (3344 in chips) 
Seat 7: LtGrimms (4126 in chips) 
Seat 8: Adios89 (3681 in chips) 
Seat 9: kartrid (2521 in chips) 
mecco: posts small blind 25
LtGrimms: posts big blind 50
*** HOLE CARDS ***
Dealt to LtGrimms [7c 3d]
Adios89: folds 
kartrid: folds 
gits1980: calls 50
rastamanooo: folds 
liamkid: folds 
R@nTAnpl@N: calls 50
Fakhish: folds 
mecco: calls 25
LtGrimms: checks 
*** FLOP *** [2s 9d Jc]
mecco: checks 
LtGrimms: checks 
gits1980: bets 100
R@nTAnpl@N: folds 
mecco: folds 
LtGrimms: folds 
Uncalled bet (100) returned to gits1980
gits1980 collected 200 from pot
gits1980: doesn't show hand 
*** SUMMARY ***
Total pot 200 | Rake 0 
Board [2s 9d Jc]
Seat 1: gits1980 collected (200)
Seat 2: rastamanooo folded before Flop (didn't bet)
Seat 3: liamkid folded before Flop (didn't bet)
Seat 4: R@nTAnpl@N folded on the Flop
Seat 5: Fakhish (button) folded before Flop (didn't bet)
Seat 6: mecco (small blind) folded on the Flop
Seat 7: LtGrimms (big blind) folded on the Flop
Seat 8: Adios89 folded before Flop (didn't bet)
Seat 9: kartrid folded before Flop (didn't bet)



PokerStars Hand #139419342717: Tournament #1292680929, $10+$1 USD Hold'em No Limit - Level IV (25/50) - 2015/08/15 14:02:21 ET
Table '1292680929 17' 9-max Seat #6 is the button
Seat 1: gits1980 (3195 in chips) 
Seat 2: rastamanooo (2590 in chips) 
Seat 3: liamkid (1939 in chips) 
Seat 4: R@nTAnpl@N (2372 in chips) 
Seat 5: Fakhish (3000 in chips) 
Seat 6: mecco (3294 in chips) 
Seat 7: LtGrimms (4076 in chips) 
Seat 8: Adios89 (3681 in chips) 
Seat 9: kartrid (2521 in chips) 
LtGrimms: posts small blind 25
Adios89: posts big blind 50
*** HOLE CARDS ***
Dealt to LtGrimms [Jd 7s]
kartrid: folds 
gits1980: raises 100 to 150
rastamanooo: folds 
liamkid: folds 
R@nTAnpl@N: folds 
Fakhish: folds 
mecco: folds 
LtGrimms: folds 
Adios89: calls 100
*** FLOP *** [Qs Js Ad]
Adios89: checks 
gits1980: bets 162
Adios89: folds 
Uncalled bet (162) returned to gits1980
gits1980 collected 325 from pot
gits1980: doesn't show hand 
*** SUMMARY ***
Total pot 325 | Rake 0 
Board [Qs Js Ad]
Seat 1: gits1980 collected (325)
Seat 2: rastamanooo folded before Flop (didn't bet)
Seat 3: liamkid folded before Flop (didn't bet)
Seat 4: R@nTAnpl@N folded before Flop (didn't bet)
Seat 5: Fakhish folded before Flop (didn't bet)
Seat 6: mecco (button) folded before Flop (didn't bet)
Seat 7: LtGrimms (small blind) folded before Flop
Seat 8: Adios89 (big blind) folded on the Flop
Seat 9: kartrid folded before Flop (didn't bet)



PokerStars Hand #139419383504: Tournament #1292680929, $10+$1 USD Hold'em No Limit - Level V (30/60) - 2015/08/15 14:03:22 ET
Table '1292680929 17' 9-max Seat #7 is the button
Seat 1: gits1980 (3370 in chips) 
Seat 2: rastamanooo (2590 in chips) 
Seat 3: liamkid (1939 in chips) 
Seat 4: R@nTAnpl@N (2372 in chips) 
Seat 5: Fakhish (3000 in chips) 
Seat 6: mecco (3294 in chips) 
Seat 7: LtGrimms (4051 in chips) 
Seat 8: Adios89 (3531 in chips) 
Seat 9: kartrid (2521 in chips) 
Adios89: posts small blind 30
kartrid: posts big blind 60
*** HOLE CARDS ***
Dealt to LtGrimms [Js Kh]
gits1980: calls 60
rastamanooo: folds 
liamkid: folds 
R@nTAnpl@N: folds 
Fakhish: folds 
mecco: folds 
LtGrimms: calls 60
Adios89: folds 
kartrid: checks 
*** FLOP *** [2h 6s Kd]
kartrid: checks 
gits1980: bets 60
LtGrimms: raises 190 to 250
kartrid: folds 
gits1980: folds 
Uncalled bet (190) returned to LtGrimms
LtGrimms collected 330 from pot
*** SUMMARY ***
Total pot 330 | Rake 0 
Board [2h 6s Kd]
Seat 1: gits1980 folded on the Flop
Seat 2: rastamanooo folded before Flop (didn't bet)
Seat 3: liamkid folded before Flop (didn't bet)
Seat 4: R@nTAnpl@N folded before Flop (didn't bet)
Seat 5: Fakhish folded before Flop (didn't bet)
Seat 6: mecco folded before Flop (didn't bet)
Seat 7: LtGrimms (button) collected (330)
Seat 8: Adios89 (small blind) folded before Flop
Seat 9: kartrid (big blind) folded on the Flop



PokerStars Hand #139419428001: Tournament #1292680929, $10+$1 USD Hold'em No Limit - Level V (30/60) - 2015/08/15 14:04:26 ET
Table '1292680929 17' 9-max Seat #8 is the button
Seat 1: gits1980 (3250 in chips) 
Seat 2: rastamanooo (2590 in chips) 
Seat 3: liamkid (1939 in chips) 
Seat 4: R@nTAnpl@N (2372 in chips) 
Seat 5: Fakhish (3000 in chips) 
Seat 6: mecco (3294 in chips) 
Seat 7: LtGrimms (4261 in chips) 
Seat 8: Adios89 (3501 in chips) 
Seat 9: kartrid (2461 in chips) 
kartrid: posts small blind 30
gits1980: posts big blind 60
*** HOLE CARDS ***
Dealt to LtGrimms [Tc 6c]
rastamanooo: folds 
liamkid: folds 
R@nTAnpl@N: folds 
Fakhish: raises 60 to 120
mecco: folds 
LtGrimms: folds 
Adios89: folds 
kartrid: folds 
gits1980: folds 
Uncalled bet (60) returned to Fakhish
Fakhish collected 150 from pot
*** SUMMARY ***
Total pot 150 | Rake 0 
Seat 1: gits1980 (big blind) folded before Flop
Seat 2: rastamanooo folded before Flop (didn't bet)
Seat 3: liamkid folded before Flop (didn't bet)
Seat 4: R@nTAnpl@N folded before Flop (didn't bet)
Seat 5: Fakhish collected (150)
Seat 6: mecco folded before Flop (didn't bet)
Seat 7: LtGrimms folded before Flop (didn't bet)
Seat 8: Adios89 (button) folded before Flop (didn't bet)
Seat 9: kartrid (small blind) folded before Flop



PokerStars Hand #139419446488: Tournament #1292680929, $10+$1 USD Hold'em No Limit - Level V (30/60) - 2015/08/15 14:04:52 ET
Table '1292680929 17' 9-max Seat #9 is the button
Seat 1: gits1980 (3190 in chips) 
Seat 2: rastamanooo (2590 in chips) 
Seat 3: liamkid (1939 in chips) 
Seat 4: R@nTAnpl@N (2372 in chips) 
Seat 5: Fakhish (3090 in chips) 
Seat 6: mecco (3294 in chips) 
Seat 7: LtGrimms (4261 in chips) 
Seat 8: Adios89 (3501 in chips) 
Seat 9: kartrid (2431 in chips) 
gits1980: posts small blind 30
rastamanooo: posts big blind 60
*** HOLE CARDS ***
Dealt to LtGrimms [Js 2h]
liamkid: folds 
R@nTAnpl@N: folds 
Fakhish: folds 
mecco: folds 
LtGrimms: folds 
Adios89: folds 
kartrid: raises 60 to 120
gits1980: calls 90
rastamanooo: calls 60
*** FLOP *** [8d As Th]
gits1980: checks 
rastamanooo: checks 
kartrid: checks 
*** TURN *** [8d As Th] [Qc]
gits1980: bets 180
rastamanooo: calls 180
kartrid: calls 180
*** RIVER *** [8d As Th Qc] [Tc]
gits1980: bets 60
rastamanooo: calls 60
kartrid: calls 60
*** SHOW DOWN ***
gits1980: shows [9d Jh] (a straight, Eight to Queen)
rastamanooo: mucks hand 
kartrid: mucks hand 
gits1980 collected 1080 from pot
*** SUMMARY ***
Total pot 1080 | Rake 0 
Board [8d As Th Qc Tc]
Seat 1: gits1980 (small blind) showed [9d Jh] and won (1080) with a straight, Eight to Queen
Seat 2: rastamanooo (big blind) mucked [Jd Ad]
Seat 3: liamkid folded before Flop (didn't bet)
Seat 4: R@nTAnpl@N folded before Flop (didn't bet)
Seat 5: Fakhish folded before Flop (didn't bet)
Seat 6: mecco folded before Flop (didn't bet)
Seat 7: LtGrimms folded before Flop (didn't bet)
Seat 8: Adios89 folded before Flop (didn't bet)
Seat 9: kartrid (button) mucked [Kd Kh]



PokerStars Hand #139419510110: Tournament #1292680929, $10+$1 USD Hold'em No Limit - Level V (30/60) - 2015/08/15 14:06:23 ET
Table '1292680929 17' 9-max Seat #1 is the button
Seat 1: gits1980 (3910 in chips) 
Seat 2: rastamanooo (2230 in chips) 
Seat 3: liamkid (1939 in chips) 
Seat 4: R@nTAnpl@N (2372 in chips) 
Seat 5: Fakhish (3090 in chips) 
Seat 6: mecco (3294 in chips) 
Seat 7: LtGrimms (4261 in chips) 
Seat 8: Adios89 (3501 in chips) 
Seat 9: kartrid (2071 in chips) 
rastamanooo: posts small blind 30
liamkid: posts big blind 60
*** HOLE CARDS ***
Dealt to LtGrimms [4s Jc]
R@nTAnpl@N: folds 
Fakhish: folds 
mecco: folds 
LtGrimms: folds 
Adios89: folds 
kartrid: folds 
gits1980: calls 60
rastamanooo is connected 
rastamanooo: folds 
liamkid: checks 
*** FLOP *** [7c Qd 7s]
liamkid: bets 60
gits1980: folds 
Uncalled bet (60) returned to liamkid
liamkid collected 150 from pot
liamkid: doesn't show hand 
*** SUMMARY ***
Total pot 150 | Rake 0 
Board [7c Qd 7s]
Seat 1: gits1980 (button) folded on the Flop
Seat 2: rastamanooo (small blind) folded before Flop
Seat 3: liamkid (big blind) collected (150)
Seat 4: R@nTAnpl@N folded before Flop (didn't bet)
Seat 5: Fakhish folded before Flop (didn't bet)
Seat 6: mecco folded before Flop (didn't bet)
Seat 7: LtGrimms folded before Flop (didn't bet)
Seat 8: Adios89 folded before Flop (didn't bet)
Seat 9: kartrid folded before Flop (didn't bet)



PokerStars Hand #139419560001: Tournament #1292680929, $10+$1 USD Hold'em No Limit - Level V (30/60) - 2015/08/15 14:07:35 ET
Table '1292680929 17' 9-max Seat #2 is the button
Seat 1: gits1980 (3850 in chips) 
Seat 2: rastamanooo (2200 in chips) 
Seat 3: liamkid (2029 in chips) 
Seat 4: R@nTAnpl@N (2372 in chips) 
Seat 5: Fakhish (3090 in chips) 
Seat 6: mecco (3294 in chips) 
Seat 7: LtGrimms (4261 in chips) 
Seat 8: Adios89 (3501 in chips) 
Seat 9: kartrid (2071 in chips) 
liamkid: posts small blind 30
R@nTAnpl@N: posts big blind 60
*** HOLE CARDS ***
Dealt to LtGrimms [Ac Th]
Fakhish: folds 
mecco: raises 120 to 180
LtGrimms: folds 
Adios89: folds 
kartrid: folds 
gits1980: folds 
rastamanooo: folds 
liamkid: folds 
R@nTAnpl@N: folds 
Uncalled bet (120) returned to mecco
mecco collected 150 from pot
mecco: doesn't show hand 
*** SUMMARY ***
Total pot 150 | Rake 0 
Seat 1: gits1980 folded before Flop (didn't bet)
Seat 2: rastamanooo (button) folded before Flop (didn't bet)
Seat 3: liamkid (small blind) folded before Flop
Seat 4: R@nTAnpl@N (big blind) folded before Flop
Seat 5: Fakhish folded before Flop (didn't bet)
Seat 6: mecco collected (150)
Seat 7: LtGrimms folded before Flop (didn't bet)
Seat 8: Adios89 folded before Flop (didn't bet)
Seat 9: kartrid folded before Flop (didn't bet)



PokerStars Hand #139419586287: Tournament #1292680929, $10+$1 USD Hold'em No Limit - Level V (30/60) - 2015/08/15 14:08:12 ET
Table '1292680929 17' 9-max Seat #3 is the button
Seat 1: gits1980 (3850 in chips) 
Seat 2: rastamanooo (2200 in chips) 
Seat 3: liamkid (1999 in chips) 
Seat 4: R@nTAnpl@N (2312 in chips) 
Seat 5: Fakhish (3090 in chips) 
Seat 6: mecco (3384 in chips) 
Seat 7: LtGrimms (4261 in chips) 
Seat 8: Adios89 (3501 in chips) 
Seat 9: kartrid (2071 in chips) 
R@nTAnpl@N: posts small blind 30
Fakhish: posts big blind 60
*** HOLE CARDS ***
Dealt to LtGrimms [3c Td]
mecco: folds 
LtGrimms: folds 
Adios89: folds 
kartrid: raises 60 to 120
gits1980: folds 
rastamanooo: folds 
liamkid: folds 
R@nTAnpl@N: folds 
Fakhish: calls 60
*** FLOP *** [4s Qc Ah]
Fakhish: checks 
kartrid: checks 
*** TURN *** [4s Qc Ah] [Ts]
Fakhish: bets 240
kartrid: folds 
Uncalled bet (240) returned to Fakhish
Fakhish collected 270 from pot
*** SUMMARY ***
Total pot 270 | Rake 0 
Board [4s Qc Ah Ts]
Seat 1: gits1980 folded before Flop (didn't bet)
Seat 2: rastamanooo folded before Flop (didn't bet)
Seat 3: liamkid (button) folded before Flop (didn't bet)
Seat 4: R@nTAnpl@N (small blind) folded before Flop
Seat 5: Fakhish (big blind) collected (270)
Seat 6: mecco folded before Flop (didn't bet)
Seat 7: LtGrimms folded before Flop (didn't bet)
Seat 8: Adios89 folded before Flop (didn't bet)
Seat 9: kartrid folded on the Turn



PokerStars Hand #139419631945: Tournament #1292680929, $10+$1 USD Hold'em No Limit - Level V (30/60) - 2015/08/15 14:09:17 ET
Table '1292680929 17' 9-max Seat #4 is the button
Seat 1: gits1980 (3850 in chips) 
Seat 2: rastamanooo (2200 in chips) 
Seat 3: liamkid (1999 in chips) 
Seat 4: R@nTAnpl@N (2282 in chips) 
Seat 5: Fakhish (3240 in chips) 
Seat 6: mecco (3384 in chips) 
Seat 7: LtGrimms (4261 in chips) 
Seat 8: Adios89 (3501 in chips) 
Seat 9: kartrid (1951 in chips) 
Fakhish: posts small blind 30
mecco: posts big blind 60
*** HOLE CARDS ***
Dealt to LtGrimms [6s Kc]
LtGrimms: folds 
Adios89: raises 90 to 150
kartrid: folds 
gits1980: folds 
rastamanooo: folds 
liamkid: folds 
R@nTAnpl@N: folds 
Fakhish: folds 
mecco: folds 
Uncalled bet (90) returned to Adios89
Adios89 collected 150 from pot
*** SUMMARY ***
Total pot 150 | Rake 0 
Seat 1: gits1980 folded before Flop (didn't bet)
Seat 2: rastamanooo folded before Flop (didn't bet)
Seat 3: liamkid folded before Flop (didn't bet)
Seat 4: R@nTAnpl@N (button) folded before Flop (didn't bet)
Seat 5: Fakhish (small blind) folded before Flop
Seat 6: mecco (big blind) folded before Flop
Seat 7: LtGrimms folded before Flop (didn't bet)
Seat 8: Adios89 collected (150)
Seat 9: kartrid folded before Flop (didn't bet)



PokerStars Hand #139419675742: Tournament #1292680929, $10+$1 USD Hold'em No Limit - Level V (30/60) - 2015/08/15 14:10:20 ET
Table '1292680929 17' 9-max Seat #5 is the button
Seat 1: gits1980 (3850 in chips) 
Seat 2: rastamanooo (2200 in chips) 
Seat 3: liamkid (1999 in chips) 
Seat 4: R@nTAnpl@N (2282 in chips) 
Seat 5: Fakhish (3210 in chips) 
Seat 6: mecco (3324 in chips) 
Seat 7: LtGrimms (4261 in chips) 
Seat 8: Adios89 (3591 in chips) 
Seat 9: kartrid (1951 in chips) 
mecco: posts small blind 30
LtGrimms: posts big blind 60
*** HOLE CARDS ***
Dealt to LtGrimms [Ks 8s]
Adios89: folds 
kartrid: folds 
gits1980 has timed out
gits1980: folds 
gits1980 is sitting out
rastamanooo: folds 
liamkid: folds 
R@nTAnpl@N: folds 
Fakhish: folds 
mecco: calls 30
LtGrimms: checks 
*** FLOP *** [Kc 2c Ah]
mecco: bets 60
LtGrimms: calls 60
*** TURN *** [Kc 2c Ah] [9d]
mecco: checks 
LtGrimms: checks 
*** RIVER *** [Kc 2c Ah 9d] [2h]
mecco: folds 
LtGrimms collected 240 from pot
*** SUMMARY ***
Total pot 240 | Rake 0 
Board [Kc 2c Ah 9d 2h]
Seat 1: gits1980 folded before Flop (didn't bet)
Seat 2: rastamanooo folded before Flop (didn't bet)
Seat 3: liamkid folded before Flop (didn't bet)
Seat 4: R@nTAnpl@N folded before Flop (didn't bet)
Seat 5: Fakhish (button) folded before Flop (didn't bet)
Seat 6: mecco (small blind) folded on the River
Seat 7: LtGrimms (big blind) collected (240)
Seat 8: Adios89 folded before Flop (didn't bet)
Seat 9: kartrid folded before Flop (didn't bet)



PokerStars Hand #139419718344: Tournament #1292680929, $10+$1 USD Hold'em No Limit - Level V (30/60) - 2015/08/15 14:11:21 ET
Table '1292680929 17' 9-max Seat #6 is the button
Seat 1: gits1980 (3850 in chips) is sitting out
Seat 2: rastamanooo (2200 in chips) 
Seat 3: liamkid (1999 in chips) 
Seat 4: R@nTAnpl@N (2282 in chips) 
Seat 5: Fakhish (3210 in chips) 
Seat 6: mecco (3204 in chips) 
Seat 7: LtGrimms (4381 in chips) 
Seat 8: Adios89 (3591 in chips) 
Seat 9: kartrid (1951 in chips) 
LtGrimms: posts small blind 30
Adios89: posts big blind 60
*** HOLE CARDS ***
Dealt to LtGrimms [9c Kh]
kartrid: folds 
gits1980: folds 
rastamanooo: folds 
liamkid: folds 
R@nTAnpl@N: folds 
Fakhish: folds 
mecco: raises 120 to 180
LtGrimms: folds 
Adios89: folds 
Uncalled bet (120) returned to mecco
mecco collected 150 from pot
mecco: doesn't show hand 
*** SUMMARY ***
Total pot 150 | Rake 0 
Seat 1: gits1980 folded before Flop (didn't bet)
Seat 2: rastamanooo folded before Flop (didn't bet)
Seat 3: liamkid folded before Flop (didn't bet)
Seat 4: R@nTAnpl@N folded before Flop (didn't bet)
Seat 5: Fakhish folded before Flop (didn't bet)
Seat 6: mecco (button) collected (150)
Seat 7: LtGrimms (small blind) folded before Flop
Seat 8: Adios89 (big blind) folded before Flop
Seat 9: kartrid folded before Flop (didn't bet)



PokerStars Hand #139419755608: Tournament #1292680929, $10+$1 USD Hold'em No Limit - Level V (30/60) - 2015/08/15 14:12:14 ET
Table '1292680929 17' 9-max Seat #7 is the button
Seat 1: gits1980 (3850 in chips) is sitting out
Seat 2: rastamanooo (2200 in chips) 
Seat 3: liamkid (1999 in chips) 
Seat 4: R@nTAnpl@N (2282 in chips) 
Seat 5: Fakhish (3210 in chips) 
Seat 6: mecco (3294 in chips) 
Seat 7: LtGrimms (4351 in chips) 
Seat 8: Adios89 (3531 in chips) 
Seat 9: kartrid (1951 in chips) 
Adios89: posts small blind 30
kartrid: posts big blind 60
*** HOLE CARDS ***
Dealt to LtGrimms [8c Kd]
gits1980: folds 
rastamanooo: folds 
liamkid: folds 
gits1980 has returned
R@nTAnpl@N: folds 
Fakhish: folds 
mecco: raises 180 to 240
LtGrimms: folds 
Adios89: folds 
kartrid: folds 
Uncalled bet (180) returned to mecco
mecco collected 150 from pot
mecco: doesn't show hand 
*** SUMMARY ***
Total pot 150 | Rake 0 
Seat 1: gits1980 folded before Flop (didn't bet)
Seat 2: rastamanooo folded before Flop (didn't bet)
Seat 3: liamkid folded before Flop (didn't bet)
Seat 4: R@nTAnpl@N folded before Flop (didn't bet)
Seat 5: Fakhish folded before Flop (didn't bet)
Seat 6: mecco collected (150)
Seat 7: LtGrimms (button) folded before Flop (didn't bet)
Seat 8: Adios89 (small blind) folded before Flop
Seat 9: kartrid (big blind) folded before Flop



PokerStars Hand #139419787647: Tournament #1292680929, $10+$1 USD Hold'em No Limit - Level VI (40/80) - 2015/08/15 14:13:00 ET
Table '1292680929 17' 9-max Seat #8 is the button
Seat 1: gits1980 (3850 in chips) 
Seat 2: rastamanooo (2200 in chips) 
Seat 3: liamkid (1999 in chips) 
Seat 4: R@nTAnpl@N (2282 in chips) 
Seat 5: Fakhish (3210 in chips) 
Seat 6: mecco (3384 in chips) 
Seat 7: LtGrimms (4351 in chips) 
Seat 8: Adios89 (3501 in chips) 
Seat 9: kartrid (1891 in chips) 
kartrid: posts small blind 40
gits1980: posts big blind 80
*** HOLE CARDS ***
Dealt to LtGrimms [4d Qh]
rastamanooo: folds 
liamkid: folds 
R@nTAnpl@N: folds 
Fakhish: folds 
mecco: folds 
LtGrimms: folds 
Adios89: raises 120 to 200
kartrid: folds 
gits1980: calls 120
*** FLOP *** [Ad 8c Kd]
gits1980: checks 
Adios89: bets 240
gits1980: calls 240
*** TURN *** [Ad 8c Kd] [Js]
gits1980: checks 
Adios89: checks 
*** RIVER *** [Ad 8c Kd Js] [7c]
gits1980: bets 460
Adios89: folds 
Uncalled bet (460) returned to gits1980
gits1980 collected 920 from pot
gits1980: doesn't show hand 
*** SUMMARY ***
Total pot 920 | Rake 0 
Board [Ad 8c Kd Js 7c]
Seat 1: gits1980 (big blind) collected (920)
Seat 2: rastamanooo folded before Flop (didn't bet)
Seat 3: liamkid folded before Flop (didn't bet)
Seat 4: R@nTAnpl@N folded before Flop (didn't bet)
Seat 5: Fakhish folded before Flop (didn't bet)
Seat 6: mecco folded before Flop (didn't bet)
Seat 7: LtGrimms folded before Flop (didn't bet)
Seat 8: Adios89 (button) folded on the River
Seat 9: kartrid (small blind) folded before Flop



PokerStars Hand #139419828085: Tournament #1292680929, $10+$1 USD Hold'em No Limit - Level VI (40/80) - 2015/08/15 14:13:59 ET
Table '1292680929 17' 9-max Seat #9 is the button
Seat 1: gits1980 (4330 in chips) 
Seat 2: rastamanooo (2200 in chips) 
Seat 3: liamkid (1999 in chips) 
Seat 4: R@nTAnpl@N (2282 in chips) 
Seat 5: Fakhish (3210 in chips) 
Seat 6: mecco (3384 in chips) 
Seat 7: LtGrimms (4351 in chips) 
Seat 8: Adios89 (3061 in chips) 
Seat 9: kartrid (1851 in chips) 
gits1980: posts small blind 40
rastamanooo: posts big blind 80
*** HOLE CARDS ***
Dealt to LtGrimms [3d 3s]
liamkid has timed out
liamkid: folds 
liamkid is sitting out
R@nTAnpl@N: folds 
liamkid has returned
Fakhish: folds 
mecco: folds 
LtGrimms: raises 120 to 200
Adios89: folds 
kartrid: folds 
gits1980: folds 
rastamanooo: folds 
Uncalled bet (120) returned to LtGrimms
LtGrimms collected 200 from pot
*** SUMMARY ***
Total pot 200 | Rake 0 
Seat 1: gits1980 (small blind) folded before Flop
Seat 2: rastamanooo (big blind) folded before Flop
Seat 3: liamkid folded before Flop (didn't bet)
Seat 4: R@nTAnpl@N folded before Flop (didn't bet)
Seat 5: Fakhish folded before Flop (didn't bet)
Seat 6: mecco folded before Flop (didn't bet)
Seat 7: LtGrimms collected (200)
Seat 8: Adios89 folded before Flop (didn't bet)
Seat 9: kartrid (button) folded before Flop (didn't bet)



PokerStars Hand #139419860589: Tournament #1292680929, $10+$1 USD Hold'em No Limit - Level VI (40/80) - 2015/08/15 14:14:46 ET
Table '1292680929 17' 9-max Seat #1 is the button
Seat 1: gits1980 (4290 in chips) 
Seat 2: rastamanooo (2120 in chips) 
Seat 3: liamkid (1999 in chips) 
Seat 4: R@nTAnpl@N (2282 in chips) 
Seat 5: Fakhish (3210 in chips) 
Seat 6: mecco (3384 in chips) 
Seat 7: LtGrimms (4471 in chips) 
Seat 8: Adios89 (3061 in chips) 
Seat 9: kartrid (1851 in chips) 
rastamanooo: posts small blind 40
liamkid: posts big blind 80
*** HOLE CARDS ***
Dealt to LtGrimms [Ts 4s]
R@nTAnpl@N: folds 
Fakhish: folds 
mecco: folds 
LtGrimms: folds 
Adios89: folds 
kartrid: folds 
gits1980: folds 
rastamanooo: folds 
Uncalled bet (40) returned to liamkid
liamkid collected 80 from pot
liamkid: doesn't show hand 
*** SUMMARY ***
Total pot 80 | Rake 0 
Seat 1: gits1980 (button) folded before Flop (didn't bet)
Seat 2: rastamanooo (small blind) folded before Flop
Seat 3: liamkid (big blind) collected (80)
Seat 4: R@nTAnpl@N folded before Flop (didn't bet)
Seat 5: Fakhish folded before Flop (didn't bet)
Seat 6: mecco folded before Flop (didn't bet)
Seat 7: LtGrimms folded before Flop (didn't bet)
Seat 8: Adios89 folded before Flop (didn't bet)
Seat 9: kartrid folded before Flop (didn't bet)



PokerStars Hand #139419876372: Tournament #1292680929, $10+$1 USD Hold'em No Limit - Level VI (40/80) - 2015/08/15 14:15:08 ET
Table '1292680929 17' 9-max Seat #2 is the button
Seat 1: gits1980 (4290 in chips) 
Seat 2: rastamanooo (2080 in chips) 
Seat 3: liamkid (2039 in chips) 
Seat 4: R@nTAnpl@N (2282 in chips) 
Seat 5: Fakhish (3210 in chips) 
Seat 6: mecco (3384 in chips) 
Seat 7: LtGrimms (4471 in chips) 
Seat 8: Adios89 (3061 in chips) 
Seat 9: kartrid (1851 in chips) 
liamkid: posts small blind 40
R@nTAnpl@N: posts big blind 80
*** HOLE CARDS ***
Dealt to LtGrimms [4c 6h]
Fakhish: folds 
mecco: folds 
LtGrimms: folds 
Adios89: folds 
kartrid: folds 
gits1980: folds 
rastamanooo: folds 
liamkid: folds 
Uncalled bet (40) returned to R@nTAnpl@N
R@nTAnpl@N collected 80 from pot
*** SUMMARY ***
Total pot 80 | Rake 0 
Seat 1: gits1980 folded before Flop (didn't bet)
Seat 2: rastamanooo (button) folded before Flop (didn't bet)
Seat 3: liamkid (small blind) folded before Flop
Seat 4: R@nTAnpl@N (big blind) collected (80)
Seat 5: Fakhish folded before Flop (didn't bet)
Seat 6: mecco folded before Flop (didn't bet)
Seat 7: LtGrimms folded before Flop (didn't bet)
Seat 8: Adios89 folded before Flop (didn't bet)
Seat 9: kartrid folded before Flop (didn't bet)



PokerStars Hand #139419905129: Tournament #1292680929, $10+$1 USD Hold'em No Limit - Level VI (40/80) - 2015/08/15 14:15:49 ET
Table '1292680929 17' 9-max Seat #3 is the button
Seat 1: gits1980 (4290 in chips) 
Seat 2: rastamanooo (2080 in chips) 
Seat 3: liamkid (1999 in chips) 
Seat 4: R@nTAnpl@N (2322 in chips) 
Seat 5: Fakhish (3210 in chips) 
Seat 6: mecco (3384 in chips) 
Seat 7: LtGrimms (4471 in chips) 
Seat 8: Adios89 (3061 in chips) 
Seat 9: kartrid (1851 in chips) 
R@nTAnpl@N: posts small blind 40
Fakhish: posts big blind 80
*** HOLE CARDS ***
Dealt to LtGrimms [9c Ad]
mecco: folds 
LtGrimms: raises 120 to 200
Adios89: folds 
kartrid: folds 
gits1980: folds 
rastamanooo: folds 
liamkid: folds 
R@nTAnpl@N: folds 
Fakhish: raises 280 to 480
LtGrimms: calls 280
*** FLOP *** [5d 4c 3s]
Fakhish: bets 560
LtGrimms: folds 
Uncalled bet (560) returned to Fakhish
Fakhish collected 1000 from pot
*** SUMMARY ***
Total pot 1000 | Rake 0 
Board [5d 4c 3s]
Seat 1: gits1980 folded before Flop (didn't bet)
Seat 2: rastamanooo folded before Flop (didn't bet)
Seat 3: liamkid (button) folded before Flop (didn't bet)
Seat 4: R@nTAnpl@N (small blind) folded before Flop
Seat 5: Fakhish (big blind) collected (1000)
Seat 6: mecco folded before Flop (didn't bet)
Seat 7: LtGrimms folded on the Flop
Seat 8: Adios89 folded before Flop (didn't bet)
Seat 9: kartrid folded before Flop (didn't bet)



PokerStars Hand #139419950025: Tournament #1292680929, $10+$1 USD Hold'em No Limit - Level VI (40/80) - 2015/08/15 14:16:54 ET
Table '1292680929 17' 9-max Seat #4 is the button
Seat 1: gits1980 (4290 in chips) 
Seat 2: rastamanooo (2080 in chips) 
Seat 3: liamkid (1999 in chips) 
Seat 4: R@nTAnpl@N (2282 in chips) 
Seat 5: Fakhish (3730 in chips) 
Seat 6: mecco (3384 in chips) 
Seat 7: LtGrimms (3991 in chips) 
Seat 8: Adios89 (3061 in chips) 
Seat 9: kartrid (1851 in chips) 
Fakhish: posts small blind 40
mecco: posts big blind 80
*** HOLE CARDS ***
Dealt to LtGrimms [4h 8c]
LtGrimms: folds 
Adios89: folds 
kartrid: raises 80 to 160
gits1980: calls 160
rastamanooo: folds 
liamkid has timed out
liamkid: folds 
liamkid is sitting out
R@nTAnpl@N: folds 
Fakhish: calls 120
liamkid has returned
mecco: raises 3224 to 3384 and is all-in
kartrid: folds 
gits1980: folds 
Fakhish: folds 
Uncalled bet (3224) returned to mecco
mecco collected 640 from pot
mecco: doesn't show hand 
*** SUMMARY ***
Total pot 640 | Rake 0 
Seat 1: gits1980 folded before Flop
Seat 2: rastamanooo folded before Flop (didn't bet)
Seat 3: liamkid folded before Flop (didn't bet)
Seat 4: R@nTAnpl@N (button) folded before Flop (didn't bet)
Seat 5: Fakhish (small blind) folded before Flop
Seat 6: mecco (big blind) collected (640)
Seat 7: LtGrimms folded before Flop (didn't bet)
Seat 8: Adios89 folded before Flop (didn't bet)
Seat 9: kartrid folded before Flop



PokerStars Hand #139419996086: Tournament #1292680929, $10+$1 USD Hold'em No Limit - Level VI (40/80) - 2015/08/15 14:17:59 ET
Table '1292680929 17' 9-max Seat #5 is the button
Seat 1: gits1980 (4130 in chips) 
Seat 2: rastamanooo (2080 in chips) 
Seat 3: liamkid (1999 in chips) 
Seat 4: R@nTAnpl@N (2282 in chips) 
Seat 5: Fakhish (3570 in chips) 
Seat 6: mecco (3864 in chips) 
Seat 7: LtGrimms (3991 in chips) 
Seat 8: Adios89 (3061 in chips) 
Seat 9: kartrid (1691 in chips) 
mecco: posts small blind 40
LtGrimms: posts big blind 80
*** HOLE CARDS ***
Dealt to LtGrimms [Kc 5s]
Adios89: folds 
kartrid: folds 
gits1980: folds 
rastamanooo: folds 
liamkid has timed out
liamkid: folds 
liamkid is sitting out
R@nTAnpl@N: folds 
Fakhish: folds 
liamkid has returned
mecco: folds 
Uncalled bet (40) returned to LtGrimms
LtGrimms collected 80 from pot
*** SUMMARY ***
Total pot 80 | Rake 0 
Seat 1: gits1980 folded before Flop (didn't bet)
Seat 2: rastamanooo folded before Flop (didn't bet)
Seat 3: liamkid folded before Flop (didn't bet)
Seat 4: R@nTAnpl@N folded before Flop (didn't bet)
Seat 5: Fakhish (button) folded before Flop (didn't bet)
Seat 6: mecco (small blind) folded before Flop
Seat 7: LtGrimms (big blind) collected (80)
Seat 8: Adios89 folded before Flop (didn't bet)
Seat 9: kartrid folded before Flop (didn't bet)



PokerStars Hand #139420028949: Tournament #1292680929, $10+$1 USD Hold'em No Limit - Level VI (40/80) - 2015/08/15 14:18:45 ET
Table '1292680929 17' 9-max Seat #6 is the button
Seat 1: gits1980 (4130 in chips) 
Seat 2: rastamanooo (2080 in chips) 
Seat 3: liamkid (1999 in chips) 
Seat 4: R@nTAnpl@N (2282 in chips) 
Seat 5: Fakhish (3570 in chips) 
Seat 6: mecco (3824 in chips) 
Seat 7: LtGrimms (4031 in chips) 
Seat 8: Adios89 (3061 in chips) 
Seat 9: kartrid (1691 in chips) 
LtGrimms: posts small blind 40
Adios89: posts big blind 80
*** HOLE CARDS ***
Dealt to LtGrimms [Th 5c]
kartrid: folds 
gits1980: folds 
rastamanooo: folds 
liamkid: folds 
R@nTAnpl@N: folds 
Fakhish: folds 
mecco: raises 160 to 240
LtGrimms: folds 
Adios89: calls 160
*** FLOP *** [3s 8c 7d]
Adios89: checks 
mecco: bets 240
Adios89: folds 
Uncalled bet (240) returned to mecco
mecco collected 520 from pot
mecco: doesn't show hand 
*** SUMMARY ***
Total pot 520 | Rake 0 
Board [3s 8c 7d]
Seat 1: gits1980 folded before Flop (didn't bet)
Seat 2: rastamanooo folded before Flop (didn't bet)
Seat 3: liamkid folded before Flop (didn't bet)
Seat 4: R@nTAnpl@N folded before Flop (didn't bet)
Seat 5: Fakhish folded before Flop (didn't bet)
Seat 6: mecco (button) collected (520)
Seat 7: LtGrimms (small blind) folded before Flop
Seat 8: Adios89 (big blind) folded on the Flop
Seat 9: kartrid folded before Flop (didn't bet)



PokerStars Hand #139420055886: Tournament #1292680929, $10+$1 USD Hold'em No Limit - Level VI (40/80) - 2015/08/15 14:19:23 ET
Table '1292680929 17' 9-max Seat #7 is the button
Seat 1: gits1980 (4130 in chips) 
Seat 2: rastamanooo (2080 in chips) 
Seat 3: liamkid (1999 in chips) 
Seat 4: R@nTAnpl@N (2282 in chips) 
Seat 5: Fakhish (3570 in chips) 
Seat 6: mecco (4104 in chips) 
Seat 7: LtGrimms (3991 in chips) 
Seat 8: Adios89 (2821 in chips) 
Seat 9: kartrid (1691 in chips) 
Adios89: posts small blind 40
kartrid: posts big blind 80
*** HOLE CARDS ***
Dealt to LtGrimms [2c Qs]
gits1980: folds 
rastamanooo: folds 
liamkid: folds 
R@nTAnpl@N: raises 87 to 167
Fakhish: folds 
mecco: folds 
LtGrimms: folds 
Adios89: folds 
kartrid: raises 193 to 360
R@nTAnpl@N: folds 
Uncalled bet (193) returned to kartrid
kartrid collected 374 from pot
kartrid: doesn't show hand 
*** SUMMARY ***
Total pot 374 | Rake 0 
Seat 1: gits1980 folded before Flop (didn't bet)
Seat 2: rastamanooo folded before Flop (didn't bet)
Seat 3: liamkid folded before Flop (didn't bet)
Seat 4: R@nTAnpl@N folded before Flop
Seat 5: Fakhish folded before Flop (didn't bet)
Seat 6: mecco folded before Flop (didn't bet)
Seat 7: LtGrimms (button) folded before Flop (didn't bet)
Seat 8: Adios89 (small blind) folded before Flop
Seat 9: kartrid (big blind) collected (374)



PokerStars Hand #139420110072: Tournament #1292680929, $10+$1 USD Hold'em No Limit - Level VI (40/80) - 2015/08/15 14:20:40 ET
Table '1292680929 17' 9-max Seat #8 is the button
Seat 1: gits1980 (4130 in chips) 
Seat 2: rastamanooo (2080 in chips) 
Seat 3: liamkid (1999 in chips) 
Seat 4: R@nTAnpl@N (2115 in chips) 
Seat 5: Fakhish (3570 in chips) 
Seat 6: mecco (4104 in chips) 
Seat 7: LtGrimms (3991 in chips) 
Seat 8: Adios89 (2781 in chips) 
Seat 9: kartrid (1898 in chips) 
kartrid: posts small blind 40
gits1980: posts big blind 80
*** HOLE CARDS ***
Dealt to LtGrimms [7s 9d]
rastamanooo: folds 
liamkid: folds 
R@nTAnpl@N: folds 
Fakhish: folds 
mecco: folds 
LtGrimms: folds 
Adios89: raises 120 to 200
kartrid: raises 300 to 500
gits1980: folds 
Adios89: folds 
Uncalled bet (300) returned to kartrid
kartrid collected 480 from pot
kartrid: doesn't show hand 
*** SUMMARY ***
Total pot 480 | Rake 0 
Seat 1: gits1980 (big blind) folded before Flop
Seat 2: rastamanooo folded before Flop (didn't bet)
Seat 3: liamkid folded before Flop (didn't bet)
Seat 4: R@nTAnpl@N folded before Flop (didn't bet)
Seat 5: Fakhish folded before Flop (didn't bet)
Seat 6: mecco folded before Flop (didn't bet)
Seat 7: LtGrimms folded before Flop (didn't bet)
Seat 8: Adios89 (button) folded before Flop
Seat 9: kartrid (small blind) collected (480)



PokerStars Hand #139420158615: Tournament #1292680929, $10+$1 USD Hold'em No Limit - Level VI (40/80) - 2015/08/15 14:21:49 ET
Table '1292680929 17' 9-max Seat #9 is the button
Seat 1: gits1980 (4050 in chips) 
Seat 2: rastamanooo (2080 in chips) 
Seat 3: liamkid (1999 in chips) 
Seat 4: R@nTAnpl@N (2115 in chips) 
Seat 5: Fakhish (3570 in chips) 
Seat 6: mecco (4104 in chips) 
Seat 7: LtGrimms (3991 in chips) 
Seat 8: Adios89 (2581 in chips) 
Seat 9: kartrid (2178 in chips) 
gits1980: posts small blind 40
rastamanooo: posts big blind 80
*** HOLE CARDS ***
Dealt to LtGrimms [8c Td]
liamkid: folds 
R@nTAnpl@N: folds 
Fakhish: folds 
mecco: folds 
LtGrimms: raises 120 to 200
Adios89: folds 
kartrid: folds 
gits1980: folds 
rastamanooo: folds 
Uncalled bet (120) returned to LtGrimms
LtGrimms collected 200 from pot
*** SUMMARY ***
Total pot 200 | Rake 0 
Seat 1: gits1980 (small blind) folded before Flop
Seat 2: rastamanooo (big blind) folded before Flop
Seat 3: liamkid folded before Flop (didn't bet)
Seat 4: R@nTAnpl@N folded before Flop (didn't bet)
Seat 5: Fakhish folded before Flop (didn't bet)
Seat 6: mecco folded before Flop (didn't bet)
Seat 7: LtGrimms collected (200)
Seat 8: Adios89 folded before Flop (didn't bet)
Seat 9: kartrid (button) folded before Flop (didn't bet)



PokerStars Hand #139420196419: Tournament #1292680929, $10+$1 USD Hold'em No Limit - Level VII (50/100) - 2015/08/15 14:22:42 ET
Table '1292680929 17' 9-max Seat #1 is the button
Seat 1: gits1980 (4010 in chips) 
Seat 2: rastamanooo (2000 in chips) 
Seat 3: liamkid (1999 in chips) 
Seat 4: R@nTAnpl@N (2115 in chips) 
Seat 5: Fakhish (3570 in chips) 
Seat 6: mecco (4104 in chips) 
Seat 7: LtGrimms (4111 in chips) 
Seat 8: Adios89 (2581 in chips) 
Seat 9: kartrid (2178 in chips) 
gits1980: posts the ante 10
rastamanooo: posts the ante 10
liamkid: posts the ante 10
R@nTAnpl@N: posts the ante 10
Fakhish: posts the ante 10
mecco: posts the ante 10
LtGrimms: posts the ante 10
Adios89: posts the ante 10
kartrid: posts the ante 10
rastamanooo: posts small blind 50
liamkid: posts big blind 100
*** HOLE CARDS ***
Dealt to LtGrimms [6h 3h]
R@nTAnpl@N: folds 
Fakhish: raises 100 to 200
mecco: folds 
LtGrimms: folds 
Adios89: folds 
kartrid: folds 
gits1980: folds 
rastamanooo: folds 
liamkid: folds 
Uncalled bet (100) returned to Fakhish
Fakhish collected 340 from pot
*** SUMMARY ***
Total pot 340 | Rake 0 
Seat 1: gits1980 (button) folded before Flop (didn't bet)
Seat 2: rastamanooo (small blind) folded before Flop
Seat 3: liamkid (big blind) folded before Flop
Seat 4: R@nTAnpl@N folded before Flop (didn't bet)
Seat 5: Fakhish collected (340)
Seat 6: mecco folded before Flop (didn't bet)
Seat 7: LtGrimms folded before Flop (didn't bet)
Seat 8: Adios89 folded before Flop (didn't bet)
Seat 9: kartrid folded before Flop (didn't bet)



PokerStars Hand #139420226666: Tournament #1292680929, $10+$1 USD Hold'em No Limit - Level VII (50/100) - 2015/08/15 14:23:25 ET
Table '1292680929 17' 9-max Seat #2 is the button
Seat 1: gits1980 (4000 in chips) 
Seat 2: rastamanooo (1940 in chips) 
Seat 3: liamkid (1889 in chips) 
Seat 4: R@nTAnpl@N (2105 in chips) 
Seat 5: Fakhish (3800 in chips) 
Seat 6: mecco (4094 in chips) 
Seat 7: LtGrimms (4101 in chips) 
Seat 8: Adios89 (2571 in chips) 
Seat 9: kartrid (2168 in chips) 
gits1980: posts the ante 10
rastamanooo: posts the ante 10
liamkid: posts the ante 10
R@nTAnpl@N: posts the ante 10
Fakhish: posts the ante 10
mecco: posts the ante 10
LtGrimms: posts the ante 10
Adios89: posts the ante 10
kartrid: posts the ante 10
liamkid: posts small blind 50
R@nTAnpl@N: posts big blind 100
*** HOLE CARDS ***
Dealt to LtGrimms [Ah 4c]
Fakhish: folds 
mecco: folds 
LtGrimms: folds 
Adios89: folds 
kartrid: raises 100 to 200
gits1980: folds 
rastamanooo: calls 200
liamkid: folds 
R@nTAnpl@N: folds 
*** FLOP *** [6s 7h 3d]
kartrid: bets 358
rastamanooo: folds 
Uncalled bet (358) returned to kartrid
kartrid collected 640 from pot
kartrid: doesn't show hand 
*** SUMMARY ***
Total pot 640 | Rake 0 
Board [6s 7h 3d]
Seat 1: gits1980 folded before Flop (didn't bet)
Seat 2: rastamanooo (button) folded on the Flop
Seat 3: liamkid (small blind) folded before Flop
Seat 4: R@nTAnpl@N (big blind) folded before Flop
Seat 5: Fakhish folded before Flop (didn't bet)
Seat 6: mecco folded before Flop (didn't bet)
Seat 7: LtGrimms folded before Flop (didn't bet)
Seat 8: Adios89 folded before Flop (didn't bet)
Seat 9: kartrid collected (640)



PokerStars Hand #139420290844: Tournament #1292680929, $10+$1 USD Hold'em No Limit - Level VII (50/100) - 2015/08/15 14:24:56 ET
Table '1292680929 17' 9-max Seat #3 is the button
Seat 1: gits1980 (3990 in chips) 
Seat 2: rastamanooo (1730 in chips) 
Seat 3: liamkid (1829 in chips) 
Seat 4: R@nTAnpl@N (1995 in chips) 
Seat 5: Fakhish (3790 in chips) 
Seat 6: mecco (4084 in chips) 
Seat 7: LtGrimms (4091 in chips) 
Seat 8: Adios89 (2561 in chips) 
Seat 9: kartrid (2598 in chips) 
gits1980: posts the ante 10
rastamanooo: posts the ante 10
liamkid: posts the ante 10
R@nTAnpl@N: posts the ante 10
Fakhish: posts the ante 10
mecco: posts the ante 10
LtGrimms: posts the ante 10
Adios89: posts the ante 10
kartrid: posts the ante 10
R@nTAnpl@N: posts small blind 50
Fakhish: posts big blind 100
*** HOLE CARDS ***
Dealt to LtGrimms [5s 4s]
mecco: folds 
LtGrimms: folds 
Adios89: folds 
kartrid: folds 
gits1980: folds 
rastamanooo: folds 
liamkid: folds 
R@nTAnpl@N: raises 109 to 209
Fakhish: calls 109
*** FLOP *** [4h 8h 2c]
R@nTAnpl@N: bets 162
Fakhish: calls 162
*** TURN *** [4h 8h 2c] [3h]
R@nTAnpl@N: bets 266
Fakhish: folds 
Uncalled bet (266) returned to R@nTAnpl@N
R@nTAnpl@N collected 832 from pot
*** SUMMARY ***
Total pot 832 | Rake 0 
Board [4h 8h 2c 3h]
Seat 1: gits1980 folded before Flop (didn't bet)
Seat 2: rastamanooo folded before Flop (didn't bet)
Seat 3: liamkid (button) folded before Flop (didn't bet)
Seat 4: R@nTAnpl@N (small blind) collected (832)
Seat 5: Fakhish (big blind) folded on the Turn
Seat 6: mecco folded before Flop (didn't bet)
Seat 7: LtGrimms folded before Flop (didn't bet)
Seat 8: Adios89 folded before Flop (didn't bet)
Seat 9: kartrid folded before Flop (didn't bet)



PokerStars Hand #139420344303: Tournament #1292680929, $10+$1 USD Hold'em No Limit - Level VII (50/100) - 2015/08/15 14:26:12 ET
Table '1292680929 17' 9-max Seat #4 is the button
Seat 1: gits1980 (3980 in chips) 
Seat 2: rastamanooo (1720 in chips) 
Seat 3: liamkid (1819 in chips) 
Seat 4: R@nTAnpl@N (2446 in chips) 
Seat 5: Fakhish (3409 in chips) 
Seat 6: mecco (4074 in chips) 
Seat 7: LtGrimms (4081 in chips) 
Seat 8: Adios89 (2551 in chips) 
Seat 9: kartrid (2588 in chips) 
gits1980: posts the ante 10
rastamanooo: posts the ante 10
liamkid: posts the ante 10
R@nTAnpl@N: posts the ante 10
Fakhish: posts the ante 10
mecco: posts the ante 10
LtGrimms: posts the ante 10
Adios89: posts the ante 10
kartrid: posts the ante 10
Fakhish: posts small blind 50
mecco: posts big blind 100
*** HOLE CARDS ***
Dealt to LtGrimms [3h 3s]
LtGrimms: folds 
Adios89: raises 100 to 200
kartrid: folds 
gits1980: folds 
rastamanooo: folds 
liamkid: folds 
R@nTAnpl@N: folds 
Fakhish: folds 
mecco: calls 100
*** FLOP *** [Td Jd 9s]
mecco: checks 
Adios89: bets 300
mecco: calls 300
*** TURN *** [Td Jd 9s] [5h]
mecco: checks 
Adios89: bets 600
mecco: folds 
Uncalled bet (600) returned to Adios89
Adios89 collected 1140 from pot
*** SUMMARY ***
Total pot 1140 | Rake 0 
Board [Td Jd 9s 5h]
Seat 1: gits1980 folded before Flop (didn't bet)
Seat 2: rastamanooo folded before Flop (didn't bet)
Seat 3: liamkid folded before Flop (didn't bet)
Seat 4: R@nTAnpl@N (button) folded before Flop (didn't bet)
Seat 5: Fakhish (small blind) folded before Flop
Seat 6: mecco (big blind) folded on the Turn
Seat 7: LtGrimms folded before Flop (didn't bet)
Seat 8: Adios89 collected (1140)
Seat 9: kartrid folded before Flop (didn't bet)



PokerStars Hand #139420383543: Tournament #1292680929, $10+$1 USD Hold'em No Limit - Level VII (50/100) - 2015/08/15 14:27:07 ET
Table '1292680929 17' 9-max Seat #5 is the button
Seat 1: gits1980 (3970 in chips) 
Seat 2: rastamanooo (1710 in chips) 
Seat 3: liamkid (1809 in chips) 
Seat 4: R@nTAnpl@N (2436 in chips) 
Seat 5: Fakhish (3349 in chips) 
Seat 6: mecco (3564 in chips) 
Seat 7: LtGrimms (4071 in chips) 
Seat 8: Adios89 (3181 in chips) 
Seat 9: kartrid (2578 in chips) 
gits1980: posts the ante 10
rastamanooo: posts the ante 10
liamkid: posts the ante 10
R@nTAnpl@N: posts the ante 10
Fakhish: posts the ante 10
mecco: posts the ante 10
LtGrimms: posts the ante 10
Adios89: posts the ante 10
kartrid: posts the ante 10
mecco: posts small blind 50
LtGrimms: posts big blind 100
*** HOLE CARDS ***
Dealt to LtGrimms [Tc 7d]
Adios89: raises 100 to 200
kartrid: folds 
gits1980: folds 
rastamanooo: folds 
liamkid: folds 
R@nTAnpl@N: folds 
Fakhish: calls 200
mecco: folds 
LtGrimms: calls 100
*** FLOP *** [3d Ks 6d]
LtGrimms: checks 
Adios89: bets 450
Fakhish: calls 450
LtGrimms: folds 
*** TURN *** [3d Ks 6d] [Js]
Adios89: bets 850
Fakhish: raises 1839 to 2689 and is all-in
Adios89: folds 
Uncalled bet (1839) returned to Fakhish
Fakhish collected 3340 from pot
*** SUMMARY ***
Total pot 3340 | Rake 0 
Board [3d Ks 6d Js]
Seat 1: gits1980 folded before Flop (didn't bet)
Seat 2: rastamanooo folded before Flop (didn't bet)
Seat 3: liamkid folded before Flop (didn't bet)
Seat 4: R@nTAnpl@N folded before Flop (didn't bet)
Seat 5: Fakhish (button) collected (3340)
Seat 6: mecco (small blind) folded before Flop
Seat 7: LtGrimms (big blind) folded on the Flop
Seat 8: Adios89 folded on the Turn
Seat 9: kartrid folded before Flop (didn't bet)



PokerStars Hand #139420418245: Tournament #1292680929, $10+$1 USD Hold'em No Limit - Level VII (50/100) - 2015/08/15 14:27:56 ET
Table '1292680929 17' 9-max Seat #6 is the button
Seat 1: gits1980 (3960 in chips) 
Seat 2: rastamanooo (1700 in chips) 
Seat 3: liamkid (1799 in chips) 
Seat 4: R@nTAnpl@N (2426 in chips) 
Seat 5: Fakhish (5179 in chips) 
Seat 6: mecco (3504 in chips) 
Seat 7: LtGrimms (3861 in chips) 
Seat 8: Adios89 (1671 in chips) 
Seat 9: kartrid (2568 in chips) 
gits1980: posts the ante 10
rastamanooo: posts the ante 10
liamkid: posts the ante 10
R@nTAnpl@N: posts the ante 10
Fakhish: posts the ante 10
mecco: posts the ante 10
LtGrimms: posts the ante 10
Adios89: posts the ante 10
kartrid: posts the ante 10
LtGrimms: posts small blind 50
Adios89: posts big blind 100
*** HOLE CARDS ***
Dealt to LtGrimms [Td Ks]
kartrid: folds 
gits1980: folds 
rastamanooo: folds 
liamkid: folds 
R@nTAnpl@N: folds 
Fakhish: folds 
mecco: raises 200 to 300
LtGrimms: folds 
Adios89: folds 
Uncalled bet (200) returned to mecco
mecco collected 340 from pot
mecco: doesn't show hand 
*** SUMMARY ***
Total pot 340 | Rake 0 
Seat 1: gits1980 folded before Flop (didn't bet)
Seat 2: rastamanooo folded before Flop (didn't bet)
Seat 3: liamkid folded before Flop (didn't bet)
Seat 4: R@nTAnpl@N folded before Flop (didn't bet)
Seat 5: Fakhish folded before Flop (didn't bet)
Seat 6: mecco (button) collected (340)
Seat 7: LtGrimms (small blind) folded before Flop
Seat 8: Adios89 (big blind) folded before Flop
Seat 9: kartrid folded before Flop (didn't bet)



PokerStars Hand #139420442994: Tournament #1292680929, $10+$1 USD Hold'em No Limit - Level VII (50/100) - 2015/08/15 14:28:32 ET
Table '1292680929 17' 9-max Seat #7 is the button
Seat 1: gits1980 (3950 in chips) 
Seat 2: rastamanooo (1690 in chips) 
Seat 3: liamkid (1789 in chips) 
Seat 4: R@nTAnpl@N (2416 in chips) 
Seat 5: Fakhish (5169 in chips) 
Seat 6: mecco (3734 in chips) 
Seat 7: LtGrimms (3801 in chips) 
Seat 8: Adios89 (1561 in chips) 
Seat 9: kartrid (2558 in chips) 
gits1980: posts the ante 10
rastamanooo: posts the ante 10
liamkid: posts the ante 10
R@nTAnpl@N: posts the ante 10
Fakhish: posts the ante 10
mecco: posts the ante 10
LtGrimms: posts the ante 10
Adios89: posts the ante 10
kartrid: posts the ante 10
Adios89: posts small blind 50
kartrid: posts big blind 100
*** HOLE CARDS ***
Dealt to LtGrimms [2d 3d]
gits1980: folds 
rastamanooo: folds 
liamkid: folds 
R@nTAnpl@N: raises 100 to 200
Fakhish: folds 
mecco: folds 
LtGrimms: folds 
Adios89: folds 
kartrid: folds 
Uncalled bet (100) returned to R@nTAnpl@N
R@nTAnpl@N collected 340 from pot
*** SUMMARY ***
Total pot 340 | Rake 0 
Seat 1: gits1980 folded before Flop (didn't bet)
Seat 2: rastamanooo folded before Flop (didn't bet)
Seat 3: liamkid folded before Flop (didn't bet)
Seat 4: R@nTAnpl@N collected (340)
Seat 5: Fakhish folded before Flop (didn't bet)
Seat 6: mecco folded before Flop (didn't bet)
Seat 7: LtGrimms (button) folded before Flop (didn't bet)
Seat 8: Adios89 (small blind) folded before Flop
Seat 9: kartrid (big blind) folded before Flop



PokerStars Hand #139420467906: Tournament #1292680929, $10+$1 USD Hold'em No Limit - Level VII (50/100) - 2015/08/15 14:29:07 ET
Table '1292680929 17' 9-max Seat #8 is the button
Seat 1: gits1980 (3940 in chips) 
Seat 2: rastamanooo (1680 in chips) 
Seat 3: liamkid (1779 in chips) 
Seat 4: R@nTAnpl@N (2646 in chips) 
Seat 5: Fakhish (5159 in chips) 
Seat 6: mecco (3724 in chips) 
Seat 7: LtGrimms (3791 in chips) 
Seat 8: Adios89 (1501 in chips) 
Seat 9: kartrid (2448 in chips) 
gits1980: posts the ante 10
rastamanooo: posts the ante 10
liamkid: posts the ante 10
R@nTAnpl@N: posts the ante 10
Fakhish: posts the ante 10
mecco: posts the ante 10
LtGrimms: posts the ante 10
Adios89: posts the ante 10
kartrid: posts the ante 10
kartrid: posts small blind 50
gits1980: posts big blind 100
*** HOLE CARDS ***
Dealt to LtGrimms [3c Qs]
rastamanooo: folds 
liamkid: folds 
R@nTAnpl@N: raises 100 to 200
Fakhish: folds 
mecco: folds 
LtGrimms: folds 
Adios89: folds 
kartrid: folds 
gits1980: calls 100
*** FLOP *** [3d Ks 5d]
gits1980: checks 
R@nTAnpl@N: bets 275
gits1980: folds 
Uncalled bet (275) returned to R@nTAnpl@N
R@nTAnpl@N collected 540 from pot
*** SUMMARY ***
Total pot 540 | Rake 0 
Board [3d Ks 5d]
Seat 1: gits1980 (big blind) folded on the Flop
Seat 2: rastamanooo folded before Flop (didn't bet)
Seat 3: liamkid folded before Flop (didn't bet)
Seat 4: R@nTAnpl@N collected (540)
Seat 5: Fakhish folded before Flop (didn't bet)
Seat 6: mecco folded before Flop (didn't bet)
Seat 7: LtGrimms folded before Flop (didn't bet)
Seat 8: Adios89 (button) folded before Flop (didn't bet)
Seat 9: kartrid (small blind) folded before Flop



PokerStars Hand #139420522243: Tournament #1292680929, $10+$1 USD Hold'em No Limit - Level VII (50/100) - 2015/08/15 14:30:24 ET
Table '1292680929 17' 9-max Seat #9 is the button
Seat 1: gits1980 (3730 in chips) 
Seat 2: rastamanooo (1670 in chips) 
Seat 3: liamkid (1769 in chips) 
Seat 4: R@nTAnpl@N (2976 in chips) 
Seat 5: Fakhish (5149 in chips) 
Seat 6: mecco (3714 in chips) 
Seat 7: LtGrimms (3781 in chips) 
Seat 8: Adios89 (1491 in chips) 
Seat 9: kartrid (2388 in chips) 
gits1980: posts the ante 10
rastamanooo: posts the ante 10
liamkid: posts the ante 10
R@nTAnpl@N: posts the ante 10
Fakhish: posts the ante 10
mecco: posts the ante 10
LtGrimms: posts the ante 10
Adios89: posts the ante 10
kartrid: posts the ante 10
gits1980: posts small blind 50
rastamanooo: posts big blind 100
*** HOLE CARDS ***
Dealt to LtGrimms [2d As]
liamkid: folds 
R@nTAnpl@N: folds 
Fakhish: folds 
mecco: raises 200 to 300
LtGrimms: folds 
Adios89: folds 
kartrid: folds 
gits1980: folds 
rastamanooo: folds 
Uncalled bet (200) returned to mecco
mecco collected 340 from pot
mecco: doesn't show hand 
*** SUMMARY ***
Total pot 340 | Rake 0 
Seat 1: gits1980 (small blind) folded before Flop
Seat 2: rastamanooo (big blind) folded before Flop
Seat 3: liamkid folded before Flop (didn't bet)
Seat 4: R@nTAnpl@N folded before Flop (didn't bet)
Seat 5: Fakhish folded before Flop (didn't bet)
Seat 6: mecco collected (340)
Seat 7: LtGrimms folded before Flop (didn't bet)
Seat 8: Adios89 folded before Flop (didn't bet)
Seat 9: kartrid (button) folded before Flop (didn't bet)



PokerStars Hand #139420555642: Tournament #1292680929, $10+$1 USD Hold'em No Limit - Level VII (50/100) - 2015/08/15 14:31:11 ET
Table '1292680929 17' 9-max Seat #1 is the button
Seat 1: gits1980 (3670 in chips) 
Seat 2: rastamanooo (1560 in chips) 
Seat 3: liamkid (1759 in chips) 
Seat 4: R@nTAnpl@N (2966 in chips) 
Seat 5: Fakhish (5139 in chips) 
Seat 6: mecco (3944 in chips) 
Seat 7: LtGrimms (3771 in chips) 
Seat 8: Adios89 (1481 in chips) 
Seat 9: kartrid (2378 in chips) 
gits1980: posts the ante 10
rastamanooo: posts the ante 10
liamkid: posts the ante 10
R@nTAnpl@N: posts the ante 10
Fakhish: posts the ante 10
mecco: posts the ante 10
LtGrimms: posts the ante 10
Adios89: posts the ante 10
kartrid: posts the ante 10
rastamanooo: posts small blind 50
liamkid: posts big blind 100
*** HOLE CARDS ***
Dealt to LtGrimms [2s Jd]
R@nTAnpl@N: folds 
Fakhish: raises 100 to 200
mecco: folds 
LtGrimms: folds 
Adios89: folds 
kartrid: folds 
gits1980: folds 
rastamanooo: folds 
liamkid: folds 
Uncalled bet (100) returned to Fakhish
Fakhish collected 340 from pot
*** SUMMARY ***
Total pot 340 | Rake 0 
Seat 1: gits1980 (button) folded before Flop (didn't bet)
Seat 2: rastamanooo (small blind) folded before Flop
Seat 3: liamkid (big blind) folded before Flop
Seat 4: R@nTAnpl@N folded before Flop (didn't bet)
Seat 5: Fakhish collected (340)
Seat 6: mecco folded before Flop (didn't bet)
Seat 7: LtGrimms folded before Flop (didn't bet)
Seat 8: Adios89 folded before Flop (didn't bet)
Seat 9: kartrid folded before Flop (didn't bet)



PokerStars Hand #139420589830: Tournament #1292680929, $10+$1 USD Hold'em No Limit - Level VII (50/100) - 2015/08/15 14:31:58 ET
Table '1292680929 17' 9-max Seat #2 is the button
Seat 1: gits1980 (3660 in chips) 
Seat 2: rastamanooo (1500 in chips) 
Seat 3: liamkid (1649 in chips) 
Seat 4: R@nTAnpl@N (2956 in chips) 
Seat 5: Fakhish (5369 in chips) 
Seat 6: mecco (3934 in chips) 
Seat 7: LtGrimms (3761 in chips) 
Seat 8: Adios89 (1471 in chips) 
Seat 9: kartrid (2368 in chips) 
gits1980: posts the ante 10
rastamanooo: posts the ante 10
liamkid: posts the ante 10
R@nTAnpl@N: posts the ante 10
Fakhish: posts the ante 10
mecco: posts the ante 10
LtGrimms: posts the ante 10
Adios89: posts the ante 10
kartrid: posts the ante 10
liamkid: posts small blind 50
R@nTAnpl@N: posts big blind 100
*** HOLE CARDS ***
Dealt to LtGrimms [As 8h]
Fakhish: folds 
mecco: folds 
LtGrimms: raises 120 to 220
Adios89: folds 
kartrid: folds 
gits1980: calls 220
rastamanooo: folds 
liamkid: folds 
R@nTAnpl@N: calls 120
*** FLOP *** [Ad 7d Ks]
R@nTAnpl@N: checks 
LtGrimms: bets 450
gits1980: calls 450
R@nTAnpl@N: folds 
*** TURN *** [Ad 7d Ks] [Jc]
LtGrimms: bets 900
gits1980: calls 900
*** RIVER *** [Ad 7d Ks Jc] [2c]
LtGrimms: bets 2181 and is all-in
gits1980: folds 
Uncalled bet (2181) returned to LtGrimms
LtGrimms collected 3500 from pot
*** SUMMARY ***
Total pot 3500 | Rake 0 
Board [Ad 7d Ks Jc 2c]
Seat 1: gits1980 folded on the River
Seat 2: rastamanooo (button) folded before Flop (didn't bet)
Seat 3: liamkid (small blind) folded before Flop
Seat 4: R@nTAnpl@N (big blind) folded on the Flop
Seat 5: Fakhish folded before Flop (didn't bet)
Seat 6: mecco folded before Flop (didn't bet)
Seat 7: LtGrimms collected (3500)
Seat 8: Adios89 folded before Flop (didn't bet)
Seat 9: kartrid folded before Flop (didn't bet)



PokerStars Hand #139420657574: Tournament #1292680929, $10+$1 USD Hold'em No Limit - Level VIII (60/120) - 2015/08/15 14:33:32 ET
Table '1292680929 17' 9-max Seat #3 is the button
Seat 1: gits1980 (2080 in chips) 
Seat 2: rastamanooo (1490 in chips) 
Seat 3: liamkid (1589 in chips) 
Seat 4: R@nTAnpl@N (2726 in chips) 
Seat 5: Fakhish (5359 in chips) 
Seat 6: mecco (3924 in chips) 
Seat 7: LtGrimms (5681 in chips) 
Seat 8: Adios89 (1461 in chips) 
Seat 9: kartrid (2358 in chips) 
gits1980: posts the ante 15
rastamanooo: posts the ante 15
liamkid: posts the ante 15
R@nTAnpl@N: posts the ante 15
Fakhish: posts the ante 15
mecco: posts the ante 15
LtGrimms: posts the ante 15
Adios89: posts the ante 15
kartrid: posts the ante 15
R@nTAnpl@N: posts small blind 60
Fakhish: posts big blind 120
*** HOLE CARDS ***
Dealt to LtGrimms [Kd Jd]
mecco: folds 
LtGrimms: raises 130 to 250
Adios89: folds 
kartrid: folds 
gits1980: folds 
rastamanooo: folds 
liamkid: folds 
R@nTAnpl@N: folds 
Fakhish: folds 
Uncalled bet (130) returned to LtGrimms
LtGrimms collected 435 from pot
*** SUMMARY ***
Total pot 435 | Rake 0 
Seat 1: gits1980 folded before Flop (didn't bet)
Seat 2: rastamanooo folded before Flop (didn't bet)
Seat 3: liamkid (button) folded before Flop (didn't bet)
Seat 4: R@nTAnpl@N (small blind) folded before Flop
Seat 5: Fakhish (big blind) folded before Flop
Seat 6: mecco folded before Flop (didn't bet)
Seat 7: LtGrimms collected (435)
Seat 8: Adios89 folded before Flop (didn't bet)
Seat 9: kartrid folded before Flop (didn't bet)



PokerStars Hand #139420699465: Tournament #1292680929, $10+$1 USD Hold'em No Limit - Level VIII (60/120) - 2015/08/15 14:34:29 ET
Table '1292680929 17' 9-max Seat #4 is the button
Seat 1: gits1980 (2065 in chips) 
Seat 2: rastamanooo (1475 in chips) 
Seat 3: liamkid (1574 in chips) 
Seat 4: R@nTAnpl@N (2651 in chips) 
Seat 5: Fakhish (5224 in chips) 
Seat 6: mecco (3909 in chips) 
Seat 7: LtGrimms (5981 in chips) 
Seat 8: Adios89 (1446 in chips) 
Seat 9: kartrid (2343 in chips) 
gits1980: posts the ante 15
rastamanooo: posts the ante 15
liamkid: posts the ante 15
R@nTAnpl@N: posts the ante 15
Fakhish: posts the ante 15
mecco: posts the ante 15
LtGrimms: posts the ante 15
Adios89: posts the ante 15
kartrid: posts the ante 15
Fakhish: posts small blind 60
mecco: posts big blind 120
*** HOLE CARDS ***
Dealt to LtGrimms [9s 2h]
LtGrimms: folds 
Adios89: folds 
kartrid: folds 
gits1980: folds 
rastamanooo: folds 
liamkid: raises 1439 to 1559 and is all-in
R@nTAnpl@N: folds 
Fakhish: folds 
mecco: folds 
Uncalled bet (1439) returned to liamkid
liamkid collected 435 from pot
liamkid: doesn't show hand 
*** SUMMARY ***
Total pot 435 | Rake 0 
Seat 1: gits1980 folded before Flop (didn't bet)
Seat 2: rastamanooo folded before Flop (didn't bet)
Seat 3: liamkid collected (435)
Seat 4: R@nTAnpl@N (button) folded before Flop (didn't bet)
Seat 5: Fakhish (small blind) folded before Flop
Seat 6: mecco (big blind) folded before Flop
Seat 7: LtGrimms folded before Flop (didn't bet)
Seat 8: Adios89 folded before Flop (didn't bet)
Seat 9: kartrid folded before Flop (didn't bet)



PokerStars Hand #139420725699: Tournament #1292680929, $10+$1 USD Hold'em No Limit - Level VIII (60/120) - 2015/08/15 14:35:05 ET
Table '1292680929 17' 9-max Seat #5 is the button
Seat 1: gits1980 (2050 in chips) 
Seat 2: rastamanooo (1460 in chips) 
Seat 3: liamkid (1874 in chips) 
Seat 4: R@nTAnpl@N (2636 in chips) 
Seat 5: Fakhish (5149 in chips) 
Seat 6: mecco (3774 in chips) 
Seat 7: LtGrimms (5966 in chips) 
Seat 8: Adios89 (1431 in chips) 
Seat 9: kartrid (2328 in chips) 
gits1980: posts the ante 15
rastamanooo: posts the ante 15
liamkid: posts the ante 15
R@nTAnpl@N: posts the ante 15
Fakhish: posts the ante 15
mecco: posts the ante 15
LtGrimms: posts the ante 15
Adios89: posts the ante 15
kartrid: posts the ante 15
mecco: posts small blind 60
LtGrimms: posts big blind 120
*** HOLE CARDS ***
Dealt to LtGrimms [Ah 5d]
Adios89: raises 1296 to 1416 and is all-in
kartrid: folds 
gits1980: folds 
rastamanooo: folds 
liamkid: folds 
R@nTAnpl@N: folds 
Fakhish: folds 
mecco: folds 
LtGrimms: folds 
Uncalled bet (1296) returned to Adios89
Adios89 collected 435 from pot
*** SUMMARY ***
Total pot 435 | Rake 0 
Seat 1: gits1980 folded before Flop (didn't bet)
Seat 2: rastamanooo folded before Flop (didn't bet)
Seat 3: liamkid folded before Flop (didn't bet)
Seat 4: R@nTAnpl@N folded before Flop (didn't bet)
Seat 5: Fakhish (button) folded before Flop (didn't bet)
Seat 6: mecco (small blind) folded before Flop
Seat 7: LtGrimms (big blind) folded before Flop
Seat 8: Adios89 collected (435)
Seat 9: kartrid folded before Flop (didn't bet)



PokerStars Hand #139420773552: Tournament #1292680929, $10+$1 USD Hold'em No Limit - Level VIII (60/120) - 2015/08/15 14:36:10 ET
Table '1292680929 17' 9-max Seat #6 is the button
Seat 1: gits1980 (2035 in chips) 
Seat 2: rastamanooo (1445 in chips) 
Seat 3: liamkid (1859 in chips) 
Seat 4: R@nTAnpl@N (2621 in chips) 
Seat 5: Fakhish (5134 in chips) 
Seat 6: mecco (3699 in chips) 
Seat 7: LtGrimms (5831 in chips) 
Seat 8: Adios89 (1731 in chips) 
Seat 9: kartrid (2313 in chips) 
gits1980: posts the ante 15
rastamanooo: posts the ante 15
liamkid: posts the ante 15
R@nTAnpl@N: posts the ante 15
Fakhish: posts the ante 15
mecco: posts the ante 15
LtGrimms: posts the ante 15
Adios89: posts the ante 15
kartrid: posts the ante 15
LtGrimms: posts small blind 60
Adios89: posts big blind 120
*** HOLE CARDS ***
Dealt to LtGrimms [3h 2h]
kartrid: folds 
gits1980: folds 
rastamanooo: folds 
liamkid: folds 
R@nTAnpl@N: folds 
Fakhish: raises 120 to 240
mecco: folds 
LtGrimms: folds 
Adios89: raises 1476 to 1716 and is all-in
Fakhish: folds 
Uncalled bet (1476) returned to Adios89
Adios89 collected 675 from pot
*** SUMMARY ***
Total pot 675 | Rake 0 
Seat 1: gits1980 folded before Flop (didn't bet)
Seat 2: rastamanooo folded before Flop (didn't bet)
Seat 3: liamkid folded before Flop (didn't bet)
Seat 4: R@nTAnpl@N folded before Flop (didn't bet)
Seat 5: Fakhish folded before Flop
Seat 6: mecco (button) folded before Flop (didn't bet)
Seat 7: LtGrimms (small blind) folded before Flop
Seat 8: Adios89 (big blind) collected (675)
Seat 9: kartrid folded before Flop (didn't bet)



PokerStars Hand #139420802843: Tournament #1292680929, $10+$1 USD Hold'em No Limit - Level VIII (60/120) - 2015/08/15 14:36:51 ET
Table '1292680929 17' 9-max Seat #7 is the button
Seat 1: gits1980 (2020 in chips) 
Seat 2: rastamanooo (1430 in chips) 
Seat 3: liamkid (1844 in chips) 
Seat 4: R@nTAnpl@N (2606 in chips) 
Seat 5: Fakhish (4879 in chips) 
Seat 6: mecco (3684 in chips) 
Seat 7: LtGrimms (5756 in chips) 
Seat 8: Adios89 (2151 in chips) 
Seat 9: kartrid (2298 in chips) 
gits1980: posts the ante 15
rastamanooo: posts the ante 15
liamkid: posts the ante 15
R@nTAnpl@N: posts the ante 15
Fakhish: posts the ante 15
mecco: posts the ante 15
LtGrimms: posts the ante 15
Adios89: posts the ante 15
kartrid: posts the ante 15
Adios89: posts small blind 60
kartrid: posts big blind 120
*** HOLE CARDS ***
Dealt to LtGrimms [Qh Kh]
gits1980: folds 
rastamanooo: raises 1295 to 1415 and is all-in
liamkid: folds 
R@nTAnpl@N: folds 
Fakhish: folds 
mecco: folds 
LtGrimms: folds 
Adios89: folds 
kartrid: folds 
Uncalled bet (1295) returned to rastamanooo
rastamanooo collected 435 from pot
rastamanooo: doesn't show hand 
*** SUMMARY ***
Total pot 435 | Rake 0 
Seat 1: gits1980 folded before Flop (didn't bet)
Seat 2: rastamanooo collected (435)
Seat 3: liamkid folded before Flop (didn't bet)
Seat 4: R@nTAnpl@N folded before Flop (didn't bet)
Seat 5: Fakhish folded before Flop (didn't bet)
Seat 6: mecco folded before Flop (didn't bet)
Seat 7: LtGrimms (button) folded before Flop (didn't bet)
Seat 8: Adios89 (small blind) folded before Flop
Seat 9: kartrid (big blind) folded before Flop



PokerStars Hand #139420833703: Tournament #1292680929, $10+$1 USD Hold'em No Limit - Level VIII (60/120) - 2015/08/15 14:37:33 ET
Table '1292680929 17' 9-max Seat #8 is the button
Seat 1: gits1980 (2005 in chips) 
Seat 2: rastamanooo (1730 in chips) 
Seat 3: liamkid (1829 in chips) 
Seat 4: R@nTAnpl@N (2591 in chips) 
Seat 5: Fakhish (4864 in chips) 
Seat 6: mecco (3669 in chips) 
Seat 7: LtGrimms (5741 in chips) 
Seat 8: Adios89 (2076 in chips) 
Seat 9: kartrid (2163 in chips) 
gits1980: posts the ante 15
rastamanooo: posts the ante 15
liamkid: posts the ante 15
R@nTAnpl@N: posts the ante 15
Fakhish: posts the ante 15
mecco: posts the ante 15
LtGrimms: posts the ante 15
Adios89: posts the ante 15
kartrid: posts the ante 15
kartrid: posts small blind 60
gits1980: posts big blind 120
*** HOLE CARDS ***
Dealt to LtGrimms [5d Qd]
rastamanooo: raises 1595 to 1715 and is all-in
liamkid: folds 
R@nTAnpl@N: folds 
Fakhish: folds 
mecco: folds 
LtGrimms: folds 
Adios89: folds 
kartrid: folds 
gits1980: folds 
Uncalled bet (1595) returned to rastamanooo
rastamanooo collected 435 from pot
rastamanooo: doesn't show hand 
*** SUMMARY ***
Total pot 435 | Rake 0 
Seat 1: gits1980 (big blind) folded before Flop
Seat 2: rastamanooo collected (435)
Seat 3: liamkid folded before Flop (didn't bet)
Seat 4: R@nTAnpl@N folded before Flop (didn't bet)
Seat 5: Fakhish folded before Flop (didn't bet)
Seat 6: mecco folded before Flop (didn't bet)
Seat 7: LtGrimms folded before Flop (didn't bet)
Seat 8: Adios89 (button) folded before Flop (didn't bet)
Seat 9: kartrid (small blind) folded before Flop



PokerStars Hand #139420885947: Tournament #1292680929, $10+$1 USD Hold'em No Limit - Level VIII (60/120) - 2015/08/15 14:38:44 ET
Table '1292680929 17' 9-max Seat #9 is the button
Seat 1: gits1980 (1870 in chips) 
Seat 2: rastamanooo (2030 in chips) 
Seat 3: liamkid (1814 in chips) 
Seat 4: R@nTAnpl@N (2576 in chips) 
Seat 5: Fakhish (4849 in chips) 
Seat 6: mecco (3654 in chips) 
Seat 7: LtGrimms (5726 in chips) 
Seat 8: Adios89 (2061 in chips) 
Seat 9: kartrid (2088 in chips) 
gits1980: posts the ante 15
rastamanooo: posts the ante 15
liamkid: posts the ante 15
R@nTAnpl@N: posts the ante 15
Fakhish: posts the ante 15
mecco: posts the ante 15
LtGrimms: posts the ante 15
Adios89: posts the ante 15
kartrid: posts the ante 15
gits1980: posts small blind 60
rastamanooo: posts big blind 120
*** HOLE CARDS ***
Dealt to LtGrimms [2h 7s]
liamkid: folds 
R@nTAnpl@N: folds 
Fakhish: folds 
mecco: folds 
LtGrimms: folds 
Adios89: folds 
kartrid: folds 
gits1980: folds 
Uncalled bet (60) returned to rastamanooo
rastamanooo collected 255 from pot
rastamanooo: doesn't show hand 
*** SUMMARY ***
Total pot 255 | Rake 0 
Seat 1: gits1980 (small blind) folded before Flop
Seat 2: rastamanooo (big blind) collected (255)
Seat 3: liamkid folded before Flop (didn't bet)
Seat 4: R@nTAnpl@N folded before Flop (didn't bet)
Seat 5: Fakhish folded before Flop (didn't bet)
Seat 6: mecco folded before Flop (didn't bet)
Seat 7: LtGrimms folded before Flop (didn't bet)
Seat 8: Adios89 folded before Flop (didn't bet)
Seat 9: kartrid (button) folded before Flop (didn't bet)



PokerStars Hand #139420959745: Tournament #1292680929, $10+$1 USD Hold'em No Limit - Level VIII (60/120) - 2015/08/15 14:40:26 ET
Table '1292680929 17' 9-max Seat #1 is the button
Seat 1: gits1980 (1795 in chips) 
Seat 2: rastamanooo (2210 in chips) 
Seat 3: liamkid (1799 in chips) 
Seat 4: R@nTAnpl@N (2561 in chips) 
Seat 5: Fakhish (4834 in chips) 
Seat 6: mecco (3639 in chips) 
Seat 7: LtGrimms (5711 in chips) 
Seat 8: Adios89 (2046 in chips) 
Seat 9: kartrid (2073 in chips) 
gits1980: posts the ante 15
rastamanooo: posts the ante 15
liamkid: posts the ante 15
R@nTAnpl@N: posts the ante 15
Fakhish: posts the ante 15
mecco: posts the ante 15
LtGrimms: posts the ante 15
Adios89: posts the ante 15
kartrid: posts the ante 15
rastamanooo: posts small blind 60
liamkid: posts big blind 120
*** HOLE CARDS ***
Dealt to LtGrimms [Ah Ac]
R@nTAnpl@N: folds 
Fakhish: raises 120 to 240
mecco: calls 240
LtGrimms: raises 560 to 800
Adios89: folds 
kartrid: folds 
gits1980: folds 
rastamanooo: folds 
liamkid: folds 
Fakhish: folds 
mecco: folds 
Uncalled bet (560) returned to LtGrimms
LtGrimms collected 1035 from pot
*** SUMMARY ***
Total pot 1035 | Rake 0 
Seat 1: gits1980 (button) folded before Flop (didn't bet)
Seat 2: rastamanooo (small blind) folded before Flop
Seat 3: liamkid (big blind) folded before Flop
Seat 4: R@nTAnpl@N folded before Flop (didn't bet)
Seat 5: Fakhish folded before Flop
Seat 6: mecco folded before Flop
Seat 7: LtGrimms collected (1035)
Seat 8: Adios89 folded before Flop (didn't bet)
Seat 9: kartrid folded before Flop (didn't bet)



PokerStars Hand #139420987309: Tournament #1292680929, $10+$1 USD Hold'em No Limit - Level VIII (60/120) - 2015/08/15 14:41:03 ET
Table '1292680929 17' 9-max Seat #2 is the button
Seat 1: gits1980 (1780 in chips) 
Seat 2: rastamanooo (2135 in chips) 
Seat 3: liamkid (1664 in chips) 
Seat 4: R@nTAnpl@N (2546 in chips) 
Seat 5: Fakhish (4579 in chips) 
Seat 6: mecco (3384 in chips) 
Seat 7: LtGrimms (6491 in chips) 
Seat 8: Adios89 (2031 in chips) 
Seat 9: kartrid (2058 in chips) 
gits1980: posts the ante 15
rastamanooo: posts the ante 15
liamkid: posts the ante 15
R@nTAnpl@N: posts the ante 15
Fakhish: posts the ante 15
mecco: posts the ante 15
LtGrimms: posts the ante 15
Adios89: posts the ante 15
kartrid: posts the ante 15
liamkid: posts small blind 60
R@nTAnpl@N: posts big blind 120
*** HOLE CARDS ***
Dealt to LtGrimms [Ac 7s]
Fakhish: folds 
mecco: folds 
LtGrimms: folds 
Adios89: folds 
kartrid: folds 
gits1980: folds 
rastamanooo: raises 120 to 240
liamkid: raises 360 to 600
R@nTAnpl@N: folds 
rastamanooo: folds 
Uncalled bet (360) returned to liamkid
liamkid collected 735 from pot
liamkid: doesn't show hand 
*** SUMMARY ***
Total pot 735 | Rake 0 
Seat 1: gits1980 folded before Flop (didn't bet)
Seat 2: rastamanooo (button) folded before Flop
Seat 3: liamkid (small blind) collected (735)
Seat 4: R@nTAnpl@N (big blind) folded before Flop
Seat 5: Fakhish folded before Flop (didn't bet)
Seat 6: mecco folded before Flop (didn't bet)
Seat 7: LtGrimms folded before Flop (didn't bet)
Seat 8: Adios89 folded before Flop (didn't bet)
Seat 9: kartrid folded before Flop (didn't bet)



PokerStars Hand #139421020234: Tournament #1292680929, $10+$1 USD Hold'em No Limit - Level VIII (60/120) - 2015/08/15 14:41:48 ET
Table '1292680929 17' 9-max Seat #3 is the button
Seat 1: gits1980 (1765 in chips) 
Seat 2: rastamanooo (1880 in chips) 
Seat 3: liamkid (2144 in chips) 
Seat 4: R@nTAnpl@N (2411 in chips) 
Seat 5: Fakhish (4564 in chips) 
Seat 6: mecco (3369 in chips) 
Seat 7: LtGrimms (6476 in chips) 
Seat 8: Adios89 (2016 in chips) 
Seat 9: kartrid (2043 in chips) 
gits1980: posts the ante 15
rastamanooo: posts the ante 15
liamkid: posts the ante 15
R@nTAnpl@N: posts the ante 15
Fakhish: posts the ante 15
mecco: posts the ante 15
LtGrimms: posts the ante 15
Adios89: posts the ante 15
kartrid: posts the ante 15
R@nTAnpl@N: posts small blind 60
Fakhish: posts big blind 120
*** HOLE CARDS ***
Dealt to LtGrimms [Qh Ts]
mecco: calls 120
LtGrimms: folds 
Adios89: folds 
kartrid: raises 1908 to 2028 and is all-in
gits1980: folds 
rastamanooo: folds 
liamkid: folds 
R@nTAnpl@N: folds 
Fakhish: folds 
mecco: calls 1908
*** FLOP *** [5d Ad 7d]
*** TURN *** [5d Ad 7d] [3s]
*** RIVER *** [5d Ad 7d 3s] [2h]
*** SHOW DOWN ***
mecco: shows [Js Ah] (a pair of Aces)
kartrid: shows [Th Td] (a pair of Tens)
mecco collected 4371 from pot
kartrid finished the tournament in 418th place
*** SUMMARY ***
Total pot 4371 | Rake 0 
Board [5d Ad 7d 3s 2h]
Seat 1: gits1980 folded before Flop (didn't bet)
Seat 2: rastamanooo folded before Flop (didn't bet)
Seat 3: liamkid (button) folded before Flop (didn't bet)
Seat 4: R@nTAnpl@N (small blind) folded before Flop
Seat 5: Fakhish (big blind) folded before Flop
Seat 6: mecco showed [Js Ah] and won (4371) with a pair of Aces
Seat 7: LtGrimms folded before Flop (didn't bet)
Seat 8: Adios89 folded before Flop (didn't bet)
Seat 9: kartrid showed [Th Td] and lost with a pair of Tens



PokerStars Hand #139421070925: Tournament #1292680929, $10+$1 USD Hold'em No Limit - Level IX (75/150) - 2015/08/15 14:42:58 ET
Table '1292680929 17' 9-max Seat #4 is the button
Seat 1: gits1980 (1750 in chips) 
Seat 2: rastamanooo (1865 in chips) 
Seat 3: liamkid (2129 in chips) 
Seat 4: R@nTAnpl@N (2336 in chips) 
Seat 5: Fakhish (4429 in chips) 
Seat 6: mecco (5697 in chips) 
Seat 7: LtGrimms (6461 in chips) 
Seat 8: Adios89 (2001 in chips) 
gits1980: posts the ante 20
rastamanooo: posts the ante 20
liamkid: posts the ante 20
R@nTAnpl@N: posts the ante 20
Fakhish: posts the ante 20
mecco: posts the ante 20
LtGrimms: posts the ante 20
Adios89: posts the ante 20
Fakhish: posts small blind 75
mecco: posts big blind 150
*** HOLE CARDS ***
Dealt to LtGrimms [Ac 8c]
LtGrimms: folds 
Adios89: folds 
gits1980 has timed out
gits1980: folds 
gits1980 is sitting out
rastamanooo: folds 
liamkid: raises 1959 to 2109 and is all-in
R@nTAnpl@N: folds 
Fakhish: folds 
mecco: folds 
Uncalled bet (1959) returned to liamkid
liamkid collected 535 from pot
liamkid: doesn't show hand 
*** SUMMARY ***
Total pot 535 | Rake 0 
Seat 1: gits1980 folded before Flop (didn't bet)
Seat 2: rastamanooo folded before Flop (didn't bet)
Seat 3: liamkid collected (535)
Seat 4: R@nTAnpl@N (button) folded before Flop (didn't bet)
Seat 5: Fakhish (small blind) folded before Flop
Seat 6: mecco (big blind) folded before Flop
Seat 7: LtGrimms folded before Flop (didn't bet)
Seat 8: Adios89 folded before Flop (didn't bet)



PokerStars Hand #139421122170: Tournament #1292680929, $10+$1 USD Hold'em No Limit - Level IX (75/150) - 2015/08/15 14:44:08 ET
Table '1292680929 17' 9-max Seat #5 is the button
Seat 1: gits1980 (1730 in chips) is sitting out
Seat 2: rastamanooo (1845 in chips) 
Seat 3: liamkid (2494 in chips) 
Seat 4: R@nTAnpl@N (2316 in chips) 
Seat 5: Fakhish (4334 in chips) 
Seat 6: mecco (5527 in chips) 
Seat 7: LtGrimms (6441 in chips) 
Seat 8: Adios89 (1981 in chips) 
gits1980: posts the ante 20
rastamanooo: posts the ante 20
liamkid: posts the ante 20
R@nTAnpl@N: posts the ante 20
Fakhish: posts the ante 20
mecco: posts the ante 20
LtGrimms: posts the ante 20
Adios89: posts the ante 20
mecco: posts small blind 75
LtGrimms: posts big blind 150
*** HOLE CARDS ***
Dealt to LtGrimms [Jc 8h]
Adios89: folds 
gits1980: folds 
rastamanooo: folds 
liamkid: folds 
R@nTAnpl@N: folds 
Fakhish: raises 150 to 300
mecco: raises 600 to 900
LtGrimms: folds 
Fakhish: raises 3414 to 4314 and is all-in
mecco: folds 
Uncalled bet (3414) returned to Fakhish
Fakhish collected 2110 from pot
*** SUMMARY ***
Total pot 2110 | Rake 0 
Seat 1: gits1980 folded before Flop (didn't bet)
Seat 2: rastamanooo folded before Flop (didn't bet)
Seat 3: liamkid folded before Flop (didn't bet)
Seat 4: R@nTAnpl@N folded before Flop (didn't bet)
Seat 5: Fakhish (button) collected (2110)
Seat 6: mecco (small blind) folded before Flop
Seat 7: LtGrimms (big blind) folded before Flop
Seat 8: Adios89 folded before Flop (didn't bet)



PokerStars Hand #139421160121: Tournament #1292680929, $10+$1 USD Hold'em No Limit - Level IX (75/150) - 2015/08/15 14:45:00 ET
Table '1292680929 17' 9-max Seat #6 is the button
Seat 1: gits1980 (1710 in chips) is sitting out
Seat 2: rastamanooo (1825 in chips) 
Seat 3: liamkid (2474 in chips) 
Seat 4: R@nTAnpl@N (2296 in chips) 
Seat 5: Fakhish (5524 in chips) 
Seat 6: mecco (4607 in chips) 
Seat 7: LtGrimms (6271 in chips) 
Seat 8: Adios89 (1961 in chips) 
Seat 9: 99cards (5378 in chips) 
gits1980: posts the ante 20
rastamanooo: posts the ante 20
liamkid: posts the ante 20
R@nTAnpl@N: posts the ante 20
Fakhish: posts the ante 20
mecco: posts the ante 20
LtGrimms: posts the ante 20
Adios89: posts the ante 20
99cards: posts the ante 20
LtGrimms: posts small blind 75
Adios89: posts big blind 150
*** HOLE CARDS ***
Dealt to LtGrimms [Ac 7c]
99cards: raises 150 to 300
gits1980: folds 
rastamanooo: folds 
liamkid: folds 
R@nTAnpl@N: folds 
Fakhish: folds 
mecco: folds 
LtGrimms: folds 
Adios89: folds 
Uncalled bet (150) returned to 99cards
99cards collected 555 from pot
99cards: doesn't show hand 
*** SUMMARY ***
Total pot 555 | Rake 0 
Seat 1: gits1980 folded before Flop (didn't bet)
Seat 2: rastamanooo folded before Flop (didn't bet)
Seat 3: liamkid folded before Flop (didn't bet)
Seat 4: R@nTAnpl@N folded before Flop (didn't bet)
Seat 5: Fakhish folded before Flop (didn't bet)
Seat 6: mecco (button) folded before Flop (didn't bet)
Seat 7: LtGrimms (small blind) folded before Flop
Seat 8: Adios89 (big blind) folded before Flop
Seat 9: 99cards collected (555)



PokerStars Hand #139421180268: Tournament #1292680929, $10+$1 USD Hold'em No Limit - Level IX (75/150) - 2015/08/15 14:45:28 ET
Table '1292680929 17' 9-max Seat #7 is the button
Seat 1: gits1980 (1690 in chips) is sitting out
Seat 2: rastamanooo (1805 in chips) 
Seat 3: liamkid (2454 in chips) 
Seat 4: R@nTAnpl@N (2276 in chips) 
Seat 5: Fakhish (5504 in chips) 
Seat 6: mecco (4587 in chips) 
Seat 7: LtGrimms (6176 in chips) 
Seat 8: Adios89 (1791 in chips) 
Seat 9: 99cards (5763 in chips) 
gits1980: posts the ante 20
rastamanooo: posts the ante 20
liamkid: posts the ante 20
R@nTAnpl@N: posts the ante 20
Fakhish: posts the ante 20
mecco: posts the ante 20
LtGrimms: posts the ante 20
Adios89: posts the ante 20
99cards: posts the ante 20
Adios89: posts small blind 75
99cards: posts big blind 150
*** HOLE CARDS ***
Dealt to LtGrimms [4s 2c]
gits1980: folds 
rastamanooo: folds 
liamkid: folds 
R@nTAnpl@N: folds 
Fakhish: folds 
mecco: folds 
LtGrimms: folds 
Adios89: folds 
Uncalled bet (75) returned to 99cards
99cards collected 330 from pot
99cards: doesn't show hand 
*** SUMMARY ***
Total pot 330 | Rake 0 
Seat 1: gits1980 folded before Flop (didn't bet)
Seat 2: rastamanooo folded before Flop (didn't bet)
Seat 3: liamkid folded before Flop (didn't bet)
Seat 4: R@nTAnpl@N folded before Flop (didn't bet)
Seat 5: Fakhish folded before Flop (didn't bet)
Seat 6: mecco folded before Flop (didn't bet)
Seat 7: LtGrimms (button) folded before Flop (didn't bet)
Seat 8: Adios89 (small blind) folded before Flop
Seat 9: 99cards (big blind) collected (330)



PokerStars Hand #139421212775: Tournament #1292680929, $10+$1 USD Hold'em No Limit - Level IX (75/150) - 2015/08/15 14:46:12 ET
Table '1292680929 17' 9-max Seat #8 is the button
Seat 1: gits1980 (1670 in chips) is sitting out
Seat 2: rastamanooo (1785 in chips) 
Seat 3: liamkid (2434 in chips) 
Seat 4: R@nTAnpl@N (2256 in chips) 
Seat 5: Fakhish (5484 in chips) 
Seat 6: mecco (4567 in chips) 
Seat 7: LtGrimms (6156 in chips) 
Seat 8: Adios89 (1696 in chips) 
Seat 9: 99cards (5998 in chips) 
gits1980: posts the ante 20
rastamanooo: posts the ante 20
liamkid: posts the ante 20
R@nTAnpl@N: posts the ante 20
Fakhish: posts the ante 20
mecco: posts the ante 20
LtGrimms: posts the ante 20
Adios89: posts the ante 20
99cards: posts the ante 20
99cards: posts small blind 75
gits1980: posts big blind 150
*** HOLE CARDS ***
Dealt to LtGrimms [Qc 5c]
rastamanooo: folds 
liamkid: folds 
R@nTAnpl@N: folds 
Fakhish: raises 150 to 300
mecco: folds 
LtGrimms: folds 
Adios89: raises 1376 to 1676 and is all-in
99cards: folds 
gits1980: folds 
Fakhish: calls 1376
*** FLOP *** [3s Ac 6c]
*** TURN *** [3s Ac 6c] [8c]
*** RIVER *** [3s Ac 6c 8c] [4d]
*** SHOW DOWN ***
Fakhish: shows [Ts Kd] (high card Ace)
Adios89: shows [Ad Jd] (a pair of Aces)
Adios89 collected 3757 from pot
*** SUMMARY ***
Total pot 3757 | Rake 0 
Board [3s Ac 6c 8c 4d]
Seat 1: gits1980 (big blind) folded before Flop
Seat 2: rastamanooo folded before Flop (didn't bet)
Seat 3: liamkid folded before Flop (didn't bet)
Seat 4: R@nTAnpl@N folded before Flop (didn't bet)
Seat 5: Fakhish showed [Ts Kd] and lost with high card Ace
Seat 6: mecco folded before Flop (didn't bet)
Seat 7: LtGrimms folded before Flop (didn't bet)
Seat 8: Adios89 (button) showed [Ad Jd] and won (3757) with a pair of Aces
Seat 9: 99cards (small blind) folded before Flop



PokerStars Hand #139421242120: Tournament #1292680929, $10+$1 USD Hold'em No Limit - Level IX (75/150) - 2015/08/15 14:46:52 ET
Table '1292680929 17' 9-max Seat #9 is the button
Seat 1: gits1980 (1500 in chips) is sitting out
Seat 2: rastamanooo (1765 in chips) 
Seat 3: liamkid (2414 in chips) 
Seat 4: R@nTAnpl@N (2236 in chips) 
Seat 5: Fakhish (3788 in chips) 
Seat 6: mecco (4547 in chips) 
Seat 7: LtGrimms (6136 in chips) 
Seat 8: Adios89 (3757 in chips) 
Seat 9: 99cards (5903 in chips) 
gits1980: posts the ante 20
rastamanooo: posts the ante 20
liamkid: posts the ante 20
R@nTAnpl@N: posts the ante 20
Fakhish: posts the ante 20
mecco: posts the ante 20
LtGrimms: posts the ante 20
Adios89: posts the ante 20
99cards: posts the ante 20
gits1980: posts small blind 75
rastamanooo: posts big blind 150
*** HOLE CARDS ***
Dealt to LtGrimms [3c 2d]
liamkid: folds 
R@nTAnpl@N: folds 
Fakhish: raises 150 to 300
mecco: folds 
LtGrimms: folds 
Adios89: raises 3437 to 3737 and is all-in
99cards: folds 
gits1980: folds 
rastamanooo: folds 
Fakhish: folds 
Uncalled bet (3437) returned to Adios89
Adios89 collected 1005 from pot
*** SUMMARY ***
Total pot 1005 | Rake 0 
Seat 1: gits1980 (small blind) folded before Flop
Seat 2: rastamanooo (big blind) folded before Flop
Seat 3: liamkid folded before Flop (didn't bet)
Seat 4: R@nTAnpl@N folded before Flop (didn't bet)
Seat 5: Fakhish folded before Flop
Seat 6: mecco folded before Flop (didn't bet)
Seat 7: LtGrimms folded before Flop (didn't bet)
Seat 8: Adios89 collected (1005)
Seat 9: 99cards (button) folded before Flop (didn't bet)



PokerStars Hand #139421267521: Tournament #1292680929, $10+$1 USD Hold'em No Limit - Level IX (75/150) - 2015/08/15 14:47:27 ET
Table '1292680929 17' 9-max Seat #1 is the button
Seat 1: gits1980 (1405 in chips) is sitting out
Seat 2: rastamanooo (1595 in chips) 
Seat 3: liamkid (2394 in chips) 
Seat 4: R@nTAnpl@N (2216 in chips) 
Seat 5: Fakhish (3468 in chips) 
Seat 6: mecco (4527 in chips) 
Seat 7: LtGrimms (6116 in chips) 
Seat 8: Adios89 (4442 in chips) 
Seat 9: 99cards (5883 in chips) 
gits1980: posts the ante 20
rastamanooo: posts the ante 20
liamkid: posts the ante 20
R@nTAnpl@N: posts the ante 20
Fakhish: posts the ante 20
mecco: posts the ante 20
LtGrimms: posts the ante 20
Adios89: posts the ante 20
99cards: posts the ante 20
rastamanooo: posts small blind 75
liamkid: posts big blind 150
*** HOLE CARDS ***
Dealt to LtGrimms [2c Qd]
R@nTAnpl@N: folds 
Fakhish: folds 
mecco: folds 
LtGrimms: folds 
Adios89: folds 
99cards: folds 
gits1980: folds 
rastamanooo: raises 1350 to 1500
liamkid: folds 
Uncalled bet (1350) returned to rastamanooo
rastamanooo collected 480 from pot
rastamanooo: doesn't show hand 
*** SUMMARY ***
Total pot 480 | Rake 0 
Seat 1: gits1980 (button) folded before Flop (didn't bet)
Seat 2: rastamanooo (small blind) collected (480)
Seat 3: liamkid (big blind) folded before Flop
Seat 4: R@nTAnpl@N folded before Flop (didn't bet)
Seat 5: Fakhish folded before Flop (didn't bet)
Seat 6: mecco folded before Flop (didn't bet)
Seat 7: LtGrimms folded before Flop (didn't bet)
Seat 8: Adios89 folded before Flop (didn't bet)
Seat 9: 99cards folded before Flop (didn't bet)



PokerStars Hand #139421287468: Tournament #1292680929, $10+$1 USD Hold'em No Limit - Level IX (75/150) - 2015/08/15 14:47:54 ET
Table '1292680929 17' 9-max Seat #2 is the button
Seat 1: gits1980 (1385 in chips) is sitting out
Seat 2: rastamanooo (1905 in chips) 
Seat 3: liamkid (2224 in chips) 
Seat 4: R@nTAnpl@N (2196 in chips) 
Seat 5: Fakhish (3448 in chips) 
Seat 6: mecco (4507 in chips) 
Seat 7: LtGrimms (6096 in chips) 
Seat 8: Adios89 (4422 in chips) 
Seat 9: 99cards (5863 in chips) 
gits1980: posts the ante 20
rastamanooo: posts the ante 20
liamkid: posts the ante 20
R@nTAnpl@N: posts the ante 20
Fakhish: posts the ante 20
mecco: posts the ante 20
LtGrimms: posts the ante 20
Adios89: posts the ante 20
99cards: posts the ante 20
liamkid: posts small blind 75
R@nTAnpl@N: posts big blind 150
*** HOLE CARDS ***
Dealt to LtGrimms [5s Th]
Fakhish: folds 
mecco: folds 
LtGrimms: folds 
Adios89: folds 
99cards: folds 
gits1980: folds 
gits1980 has returned
rastamanooo: raises 150 to 300
liamkid: folds 
R@nTAnpl@N: folds 
Uncalled bet (150) returned to rastamanooo
rastamanooo collected 555 from pot
rastamanooo: doesn't show hand 
*** SUMMARY ***
Total pot 555 | Rake 0 
Seat 1: gits1980 folded before Flop (didn't bet)
Seat 2: rastamanooo (button) collected (555)
Seat 3: liamkid (small blind) folded before Flop
Seat 4: R@nTAnpl@N (big blind) folded before Flop
Seat 5: Fakhish folded before Flop (didn't bet)
Seat 6: mecco folded before Flop (didn't bet)
Seat 7: LtGrimms folded before Flop (didn't bet)
Seat 8: Adios89 folded before Flop (didn't bet)
Seat 9: 99cards folded before Flop (didn't bet)



PokerStars Hand #139421302212: Tournament #1292680929, $10+$1 USD Hold'em No Limit - Level IX (75/150) - 2015/08/15 14:48:14 ET
Table '1292680929 17' 9-max Seat #3 is the button
Seat 1: gits1980 (1365 in chips) 
Seat 2: rastamanooo (2290 in chips) 
Seat 3: liamkid (2129 in chips) 
Seat 4: R@nTAnpl@N (2026 in chips) 
Seat 5: Fakhish (3428 in chips) 
Seat 6: mecco (4487 in chips) 
Seat 7: LtGrimms (6076 in chips) 
Seat 8: Adios89 (4402 in chips) 
Seat 9: 99cards (5843 in chips) 
gits1980: posts the ante 20
rastamanooo: posts the ante 20
liamkid: posts the ante 20
R@nTAnpl@N: posts the ante 20
Fakhish: posts the ante 20
mecco: posts the ante 20
LtGrimms: posts the ante 20
Adios89: posts the ante 20
99cards: posts the ante 20
R@nTAnpl@N: posts small blind 75
Fakhish: posts big blind 150
*** HOLE CARDS ***
Dealt to LtGrimms [7h Kc]
mecco: folds 
LtGrimms: folds 
Adios89: folds 
99cards: calls 150
gits1980: folds 
rastamanooo: folds 
liamkid: folds 
R@nTAnpl@N: folds 
Fakhish: checks 
*** FLOP *** [2d 3h 5s]
Fakhish: checks 
99cards: bets 150
Fakhish: calls 150
*** TURN *** [2d 3h 5s] [6s]
Fakhish: checks 
99cards: checks 
*** RIVER *** [2d 3h 5s 6s] [9s]
Fakhish: bets 750
99cards: folds 
Uncalled bet (750) returned to Fakhish
Fakhish collected 855 from pot
*** SUMMARY ***
Total pot 855 | Rake 0 
Board [2d 3h 5s 6s 9s]
Seat 1: gits1980 folded before Flop (didn't bet)
Seat 2: rastamanooo folded before Flop (didn't bet)
Seat 3: liamkid (button) folded before Flop (didn't bet)
Seat 4: R@nTAnpl@N (small blind) folded before Flop
Seat 5: Fakhish (big blind) collected (855)
Seat 6: mecco folded before Flop (didn't bet)
Seat 7: LtGrimms folded before Flop (didn't bet)
Seat 8: Adios89 folded before Flop (didn't bet)
Seat 9: 99cards folded on the River



PokerStars Hand #139421357540: Tournament #1292680929, $10+$1 USD Hold'em No Limit - Level IX (75/150) - 2015/08/15 14:49:30 ET
Table '1292680929 17' 9-max Seat #4 is the button
Seat 1: gits1980 (1345 in chips) 
Seat 2: rastamanooo (2270 in chips) 
Seat 3: liamkid (2109 in chips) 
Seat 4: R@nTAnpl@N (1931 in chips) 
Seat 5: Fakhish (3963 in chips) 
Seat 6: mecco (4467 in chips) 
Seat 7: LtGrimms (6056 in chips) 
Seat 8: Adios89 (4382 in chips) 
Seat 9: 99cards (5523 in chips) 
gits1980: posts the ante 20
rastamanooo: posts the ante 20
liamkid: posts the ante 20
R@nTAnpl@N: posts the ante 20
Fakhish: posts the ante 20
mecco: posts the ante 20
LtGrimms: posts the ante 20
Adios89: posts the ante 20
99cards: posts the ante 20
Fakhish: posts small blind 75
mecco: posts big blind 150
*** HOLE CARDS ***
Dealt to LtGrimms [As 2d]
LtGrimms: folds 
Adios89: raises 150 to 300
99cards: folds 
gits1980: folds 
rastamanooo: folds 
liamkid: folds 
R@nTAnpl@N: folds 
Fakhish: folds 
mecco: calls 150
*** FLOP *** [2s Ad Jd]
mecco: checks 
Adios89: bets 450
mecco: calls 450
*** TURN *** [2s Ad Jd] [2h]
mecco: checks 
Adios89: checks 
*** RIVER *** [2s Ad Jd 2h] [6s]
mecco: bets 3697 and is all-in
Adios89: folds 
Uncalled bet (3697) returned to mecco
mecco collected 1755 from pot
mecco: doesn't show hand 
*** SUMMARY ***
Total pot 1755 | Rake 0 
Board [2s Ad Jd 2h 6s]
Seat 1: gits1980 folded before Flop (didn't bet)
Seat 2: rastamanooo folded before Flop (didn't bet)
Seat 3: liamkid folded before Flop (didn't bet)
Seat 4: R@nTAnpl@N (button) folded before Flop (didn't bet)
Seat 5: Fakhish (small blind) folded before Flop
Seat 6: mecco (big blind) collected (1755)
Seat 7: LtGrimms folded before Flop (didn't bet)
Seat 8: Adios89 folded on the River
Seat 9: 99cards folded before Flop (didn't bet)



PokerStars Hand #139421398102: Tournament #1292680929, $10+$1 USD Hold'em No Limit - Level IX (75/150) - 2015/08/15 14:50:26 ET
Table '1292680929 17' 9-max Seat #5 is the button
Seat 1: gits1980 (1325 in chips) 
Seat 2: rastamanooo (2250 in chips) 
Seat 3: liamkid (2089 in chips) 
Seat 4: R@nTAnpl@N (1911 in chips) 
Seat 5: Fakhish (3868 in chips) 
Seat 6: mecco (5452 in chips) 
Seat 7: LtGrimms (6036 in chips) 
Seat 8: Adios89 (3612 in chips) 
Seat 9: 99cards (5503 in chips) 
gits1980: posts the ante 20
rastamanooo: posts the ante 20
liamkid: posts the ante 20
R@nTAnpl@N: posts the ante 20
Fakhish: posts the ante 20
mecco: posts the ante 20
LtGrimms: posts the ante 20
Adios89: posts the ante 20
99cards: posts the ante 20
mecco: posts small blind 75
LtGrimms: posts big blind 150
*** HOLE CARDS ***
Dealt to LtGrimms [Ah 9d]
Adios89: folds 
99cards: calls 150
gits1980: folds 
rastamanooo: folds 
liamkid: folds 
R@nTAnpl@N: folds 
Fakhish: folds 
mecco: calls 75
LtGrimms: checks 
*** FLOP *** [Qh 6c 7h]
mecco: checks 
LtGrimms: checks 
99cards: bets 150
mecco: calls 150
LtGrimms: folds 
*** TURN *** [Qh 6c 7h] [Qd]
mecco: checks 
99cards: bets 450
mecco: raises 600 to 1050
99cards: calls 600
*** RIVER *** [Qh 6c 7h Qd] [4c]
mecco: bets 1500
99cards: folds 
Uncalled bet (1500) returned to mecco
mecco collected 3030 from pot
mecco: doesn't show hand 
*** SUMMARY ***
Total pot 3030 | Rake 0 
Board [Qh 6c 7h Qd 4c]
Seat 1: gits1980 folded before Flop (didn't bet)
Seat 2: rastamanooo folded before Flop (didn't bet)
Seat 3: liamkid folded before Flop (didn't bet)
Seat 4: R@nTAnpl@N folded before Flop (didn't bet)
Seat 5: Fakhish (button) folded before Flop (didn't bet)
Seat 6: mecco (small blind) collected (3030)
Seat 7: LtGrimms (big blind) folded on the Flop
Seat 8: Adios89 folded before Flop (didn't bet)
Seat 9: 99cards folded on the River



PokerStars Hand #139421473387: Tournament #1292680929, $10+$1 USD Hold'em No Limit - Level IX (75/150) - 2015/08/15 14:52:09 ET
Table '1292680929 17' 9-max Seat #6 is the button
Seat 1: gits1980 (1305 in chips) 
Seat 2: rastamanooo (2230 in chips) 
Seat 3: liamkid (2069 in chips) 
Seat 4: R@nTAnpl@N (1891 in chips) 
Seat 5: Fakhish (3848 in chips) 
Seat 6: mecco (7112 in chips) 
Seat 7: LtGrimms (5866 in chips) 
Seat 8: Adios89 (3592 in chips) 
Seat 9: 99cards (4133 in chips) 
gits1980: posts the ante 20
rastamanooo: posts the ante 20
liamkid: posts the ante 20
R@nTAnpl@N: posts the ante 20
Fakhish: posts the ante 20
mecco: posts the ante 20
LtGrimms: posts the ante 20
Adios89: posts the ante 20
99cards: posts the ante 20
LtGrimms: posts small blind 75
Adios89: posts big blind 150
*** HOLE CARDS ***
Dealt to LtGrimms [Jc 2d]
99cards: raises 150 to 300
gits1980: folds 
rastamanooo: folds 
liamkid: folds 
R@nTAnpl@N: raises 1571 to 1871 and is all-in
Fakhish: folds 
mecco: folds 
LtGrimms: folds 
Adios89: folds 
99cards: calls 1571
*** FLOP *** [7s 7d Ac]
*** TURN *** [7s 7d Ac] [Qc]
*** RIVER *** [7s 7d Ac Qc] [9s]
*** SHOW DOWN ***
99cards: shows [Tc Ad] (two pair, Aces and Sevens)
R@nTAnpl@N: shows [Ah Ks] (two pair, Aces and Sevens - King kicker)
R@nTAnpl@N collected 4147 from pot
*** SUMMARY ***
Total pot 4147 | Rake 0 
Board [7s 7d Ac Qc 9s]
Seat 1: gits1980 folded before Flop (didn't bet)
Seat 2: rastamanooo folded before Flop (didn't bet)
Seat 3: liamkid folded before Flop (didn't bet)
Seat 4: R@nTAnpl@N showed [Ah Ks] and won (4147) with two pair, Aces and Sevens
Seat 5: Fakhish folded before Flop (didn't bet)
Seat 6: mecco (button) folded before Flop (didn't bet)
Seat 7: LtGrimms (small blind) folded before Flop
Seat 8: Adios89 (big blind) folded before Flop
Seat 9: 99cards showed [Tc Ad] and lost with two pair, Aces and Sevens



PokerStars Hand #139421500715: Tournament #1292680929, $10+$1 USD Hold'em No Limit - Level X (100/200) - 2015/08/15 14:52:47 ET
Table '1292680929 17' 9-max Seat #7 is the button
Seat 1: gits1980 (1285 in chips) 
Seat 2: rastamanooo (2210 in chips) 
Seat 3: liamkid (2049 in chips) 
Seat 4: R@nTAnpl@N (4147 in chips) 
Seat 5: Fakhish (3828 in chips) 
Seat 6: mecco (7092 in chips) 
Seat 7: LtGrimms (5771 in chips) 
Seat 8: Adios89 (3422 in chips) 
Seat 9: 99cards (2242 in chips) 
gits1980: posts the ante 25
rastamanooo: posts the ante 25
liamkid: posts the ante 25
R@nTAnpl@N: posts the ante 25
Fakhish: posts the ante 25
mecco: posts the ante 25
LtGrimms: posts the ante 25
Adios89: posts the ante 25
99cards: posts the ante 25
Adios89: posts small blind 100
99cards: posts big blind 200
*** HOLE CARDS ***
Dealt to LtGrimms [Th As]
gits1980: folds 
rastamanooo: folds 
liamkid: folds 
R@nTAnpl@N: folds 
Fakhish: folds 
mecco: folds 
LtGrimms: raises 244 to 444
Adios89: folds 
99cards: calls 244
*** FLOP *** [Kh Jd 4h]
99cards: checks 
LtGrimms: bets 606
99cards: folds 
Uncalled bet (606) returned to LtGrimms
LtGrimms collected 1213 from pot
*** SUMMARY ***
Total pot 1213 | Rake 0 
Board [Kh Jd 4h]
Seat 1: gits1980 folded before Flop (didn't bet)
Seat 2: rastamanooo folded before Flop (didn't bet)
Seat 3: liamkid folded before Flop (didn't bet)
Seat 4: R@nTAnpl@N folded before Flop (didn't bet)
Seat 5: Fakhish folded before Flop (didn't bet)
Seat 6: mecco folded before Flop (didn't bet)
Seat 7: LtGrimms (button) collected (1213)
Seat 8: Adios89 (small blind) folded before Flop
Seat 9: 99cards (big blind) folded on the Flop



PokerStars Hand #139421526612: Tournament #1292680929, $10+$1 USD Hold'em No Limit - Level X (100/200) - 2015/08/15 14:53:23 ET
Table '1292680929 17' 9-max Seat #8 is the button
Seat 1: gits1980 (1260 in chips) 
Seat 2: rastamanooo (2185 in chips) 
Seat 3: liamkid (2024 in chips) 
Seat 4: R@nTAnpl@N (4122 in chips) 
Seat 5: Fakhish (3803 in chips) 
Seat 6: mecco (7067 in chips) 
Seat 7: LtGrimms (6515 in chips) 
Seat 8: Adios89 (3297 in chips) 
Seat 9: 99cards (1773 in chips) 
gits1980: posts the ante 25
rastamanooo: posts the ante 25
liamkid: posts the ante 25
R@nTAnpl@N: posts the ante 25
Fakhish: posts the ante 25
mecco: posts the ante 25
LtGrimms: posts the ante 25
Adios89: posts the ante 25
99cards: posts the ante 25
99cards: posts small blind 100
gits1980: posts big blind 200
*** HOLE CARDS ***
Dealt to LtGrimms [8s 6d]
rastamanooo: folds 
liamkid: folds 
R@nTAnpl@N: folds 
Fakhish: folds 
mecco: folds 
LtGrimms: folds 
Adios89: folds 
99cards: raises 200 to 400
gits1980: folds 
Uncalled bet (200) returned to 99cards
99cards collected 625 from pot
99cards: doesn't show hand 
*** SUMMARY ***
Total pot 625 | Rake 0 
Seat 1: gits1980 (big blind) folded before Flop
Seat 2: rastamanooo folded before Flop (didn't bet)
Seat 3: liamkid folded before Flop (didn't bet)
Seat 4: R@nTAnpl@N folded before Flop (didn't bet)
Seat 5: Fakhish folded before Flop (didn't bet)
Seat 6: mecco folded before Flop (didn't bet)
Seat 7: LtGrimms folded before Flop (didn't bet)
Seat 8: Adios89 (button) folded before Flop (didn't bet)
Seat 9: 99cards (small blind) collected (625)



PokerStars Hand #139421547902: Tournament #1292680929, $10+$1 USD Hold'em No Limit - Level X (100/200) - 2015/08/15 14:53:52 ET
Table '1292680929 17' 9-max Seat #9 is the button
Seat 1: gits1980 (1035 in chips) 
Seat 2: rastamanooo (2160 in chips) 
Seat 3: liamkid (1999 in chips) 
Seat 4: R@nTAnpl@N (4097 in chips) 
Seat 5: Fakhish (3778 in chips) 
Seat 6: mecco (7042 in chips) 
Seat 7: LtGrimms (6490 in chips) 
Seat 8: Adios89 (3272 in chips) 
Seat 9: 99cards (2173 in chips) 
gits1980: posts the ante 25
rastamanooo: posts the ante 25
liamkid: posts the ante 25
R@nTAnpl@N: posts the ante 25
Fakhish: posts the ante 25
mecco: posts the ante 25
LtGrimms: posts the ante 25
Adios89: posts the ante 25
99cards: posts the ante 25
gits1980: posts small blind 100
rastamanooo: posts big blind 200
*** HOLE CARDS ***
Dealt to LtGrimms [4c 5h]
liamkid: folds 
R@nTAnpl@N: folds 
Fakhish: folds 
mecco: folds 
LtGrimms: folds 
Adios89: folds 
99cards: folds 
gits1980: raises 810 to 1010 and is all-in
rastamanooo: folds 
Uncalled bet (810) returned to gits1980
gits1980 collected 625 from pot
gits1980: doesn't show hand 
*** SUMMARY ***
Total pot 625 | Rake 0 
Seat 1: gits1980 (small blind) collected (625)
Seat 2: rastamanooo (big blind) folded before Flop
Seat 3: liamkid folded before Flop (didn't bet)
Seat 4: R@nTAnpl@N folded before Flop (didn't bet)
Seat 5: Fakhish folded before Flop (didn't bet)
Seat 6: mecco folded before Flop (didn't bet)
Seat 7: LtGrimms folded before Flop (didn't bet)
Seat 8: Adios89 folded before Flop (didn't bet)
Seat 9: 99cards (button) folded before Flop (didn't bet)



PokerStars Hand #139421568032: Tournament #1292680929, $10+$1 USD Hold'em No Limit - Level X (100/200) - 2015/08/15 14:54:20 ET
Table '1292680929 17' 9-max Seat #1 is the button
Seat 1: gits1980 (1435 in chips) 
Seat 2: rastamanooo (1935 in chips) 
Seat 3: liamkid (1974 in chips) 
Seat 4: R@nTAnpl@N (4072 in chips) 
Seat 5: Fakhish (3753 in chips) 
Seat 6: mecco (7017 in chips) 
Seat 7: LtGrimms (6465 in chips) 
Seat 8: Adios89 (3247 in chips) 
Seat 9: 99cards (2148 in chips) 
gits1980: posts the ante 25
rastamanooo: posts the ante 25
liamkid: posts the ante 25
R@nTAnpl@N: posts the ante 25
Fakhish: posts the ante 25
mecco: posts the ante 25
LtGrimms: posts the ante 25
Adios89: posts the ante 25
99cards: posts the ante 25
rastamanooo: posts small blind 100
liamkid: posts big blind 200
*** HOLE CARDS ***
Dealt to LtGrimms [9d 8d]
R@nTAnpl@N: folds 
Fakhish: folds 
mecco: folds 
LtGrimms: raises 200 to 400
Adios89: folds 
99cards: folds 
gits1980: folds 
rastamanooo: raises 1510 to 1910 and is all-in
liamkid: folds 
LtGrimms: folds 
Uncalled bet (1510) returned to rastamanooo
rastamanooo collected 1225 from pot
rastamanooo: doesn't show hand 
*** SUMMARY ***
Total pot 1225 | Rake 0 
Seat 1: gits1980 (button) folded before Flop (didn't bet)
Seat 2: rastamanooo (small blind) collected (1225)
Seat 3: liamkid (big blind) folded before Flop
Seat 4: R@nTAnpl@N folded before Flop (didn't bet)
Seat 5: Fakhish folded before Flop (didn't bet)
Seat 6: mecco folded before Flop (didn't bet)
Seat 7: LtGrimms folded before Flop
Seat 8: Adios89 folded before Flop (didn't bet)
Seat 9: 99cards folded before Flop (didn't bet)



PokerStars Hand #139421826787: Tournament #1292680929, $10+$1 USD Hold'em No Limit - Level X (100/200) - 2015/08/15 15:01:42 ET
Table '1292680929 17' 9-max Seat #2 is the button
Seat 1: gits1980 (1410 in chips) 
Seat 2: rastamanooo (2735 in chips) 
Seat 3: liamkid (1749 in chips) 
Seat 4: R@nTAnpl@N (4047 in chips) 
Seat 5: Fakhish (3728 in chips) 
Seat 6: mecco (6992 in chips) 
Seat 7: LtGrimms (6040 in chips) 
Seat 8: Adios89 (3222 in chips) 
Seat 9: 99cards (2123 in chips) 
gits1980: posts the ante 25
rastamanooo: posts the ante 25
liamkid: posts the ante 25
R@nTAnpl@N: posts the ante 25
Fakhish: posts the ante 25
mecco: posts the ante 25
LtGrimms: posts the ante 25
Adios89: posts the ante 25
99cards: posts the ante 25
liamkid: posts small blind 100
R@nTAnpl@N: posts big blind 200
*** HOLE CARDS ***
Dealt to LtGrimms [4c 5c]
Fakhish: folds 
mecco: folds 
LtGrimms: folds 
Adios89: folds 
99cards: folds 
gits1980: folds 
rastamanooo: folds 
liamkid: folds 
Uncalled bet (100) returned to R@nTAnpl@N
R@nTAnpl@N collected 425 from pot
*** SUMMARY ***
Total pot 425 | Rake 0 
Seat 1: gits1980 folded before Flop (didn't bet)
Seat 2: rastamanooo (button) folded before Flop (didn't bet)
Seat 3: liamkid (small blind) folded before Flop
Seat 4: R@nTAnpl@N (big blind) collected (425)
Seat 5: Fakhish folded before Flop (didn't bet)
Seat 6: mecco folded before Flop (didn't bet)
Seat 7: LtGrimms folded before Flop (didn't bet)
Seat 8: Adios89 folded before Flop (didn't bet)
Seat 9: 99cards folded before Flop (didn't bet)



PokerStars Hand #139421842445: Tournament #1292680929, $10+$1 USD Hold'em No Limit - Level X (100/200) - 2015/08/15 15:02:04 ET
Table '1292680929 17' 9-max Seat #3 is the button
Seat 1: gits1980 (1385 in chips) 
Seat 2: rastamanooo (2710 in chips) 
Seat 3: liamkid (1624 in chips) 
Seat 4: R@nTAnpl@N (4347 in chips) 
Seat 5: Fakhish (3703 in chips) 
Seat 6: mecco (6967 in chips) 
Seat 7: LtGrimms (6015 in chips) 
Seat 8: Adios89 (3197 in chips) 
Seat 9: 99cards (2098 in chips) 
gits1980: posts the ante 25
rastamanooo: posts the ante 25
liamkid: posts the ante 25
R@nTAnpl@N: posts the ante 25
Fakhish: posts the ante 25
mecco: posts the ante 25
LtGrimms: posts the ante 25
Adios89: posts the ante 25
99cards: posts the ante 25
R@nTAnpl@N: posts small blind 100
Fakhish: posts big blind 200
*** HOLE CARDS ***
Dealt to LtGrimms [5c Qs]
mecco: folds 
LtGrimms: folds 
Adios89: folds 
99cards: folds 
gits1980: folds 
rastamanooo: folds 
liamkid: raises 1399 to 1599 and is all-in
R@nTAnpl@N: folds 
Fakhish: folds 
Uncalled bet (1399) returned to liamkid
liamkid collected 725 from pot
liamkid: doesn't show hand 
*** SUMMARY ***
Total pot 725 | Rake 0 
Seat 1: gits1980 folded before Flop (didn't bet)
Seat 2: rastamanooo folded before Flop (didn't bet)
Seat 3: liamkid (button) collected (725)
Seat 4: R@nTAnpl@N (small blind) folded before Flop
Seat 5: Fakhish (big blind) folded before Flop
Seat 6: mecco folded before Flop (didn't bet)
Seat 7: LtGrimms folded before Flop (didn't bet)
Seat 8: Adios89 folded before Flop (didn't bet)
Seat 9: 99cards folded before Flop (didn't bet)



PokerStars Hand #139421863195: Tournament #1292680929, $10+$1 USD Hold'em No Limit - Level X (100/200) - 2015/08/15 15:02:32 ET
Table '1292680929 17' 9-max Seat #4 is the button
Seat 1: gits1980 (1360 in chips) 
Seat 2: rastamanooo (2685 in chips) 
Seat 3: liamkid (2124 in chips) 
Seat 4: R@nTAnpl@N (4222 in chips) 
Seat 5: Fakhish (3478 in chips) 
Seat 6: mecco (6942 in chips) 
Seat 7: LtGrimms (5990 in chips) 
Seat 8: Adios89 (3172 in chips) 
Seat 9: 99cards (2073 in chips) 
gits1980: posts the ante 25
rastamanooo: posts the ante 25
liamkid: posts the ante 25
R@nTAnpl@N: posts the ante 25
Fakhish: posts the ante 25
mecco: posts the ante 25
LtGrimms: posts the ante 25
Adios89: posts the ante 25
99cards: posts the ante 25
Fakhish: posts small blind 100
mecco: posts big blind 200
*** HOLE CARDS ***
Dealt to LtGrimms [8d 2d]
LtGrimms: folds 
Adios89: folds 
99cards: folds 
gits1980: folds 
rastamanooo: folds 
liamkid: raises 1899 to 2099 and is all-in
R@nTAnpl@N: folds 
Fakhish: folds 
mecco: calls 1899
*** FLOP *** [9h 7c 7s]
*** TURN *** [9h 7c 7s] [Qh]
*** RIVER *** [9h 7c 7s Qh] [9s]
*** SHOW DOWN ***
mecco: shows [Qc Kh] (two pair, Queens and Nines)
liamkid: shows [4c Kc] (two pair, Nines and Sevens)
mecco collected 4523 from pot
liamkid finished the tournament in 338th place
*** SUMMARY ***
Total pot 4523 | Rake 0 
Board [9h 7c 7s Qh 9s]
Seat 1: gits1980 folded before Flop (didn't bet)
Seat 2: rastamanooo folded before Flop (didn't bet)
Seat 3: liamkid showed [4c Kc] and lost with two pair, Nines and Sevens
Seat 4: R@nTAnpl@N (button) folded before Flop (didn't bet)
Seat 5: Fakhish (small blind) folded before Flop
Seat 6: mecco (big blind) showed [Qc Kh] and won (4523) with two pair, Queens and Nines
Seat 7: LtGrimms folded before Flop (didn't bet)
Seat 8: Adios89 folded before Flop (didn't bet)
Seat 9: 99cards folded before Flop (didn't bet)



PokerStars Hand #139421917325: Tournament #1292680929, $10+$1 USD Hold'em No Limit - Level X (100/200) - 2015/08/15 15:03:42 ET
Table '1292680929 17' 9-max Seat #5 is the button
Seat 1: gits1980 (1335 in chips) 
Seat 2: rastamanooo (2660 in chips) 
Seat 4: R@nTAnpl@N (4197 in chips) 
Seat 5: Fakhish (3353 in chips) 
Seat 6: mecco (9341 in chips) 
Seat 7: LtGrimms (5965 in chips) 
Seat 8: Adios89 (3147 in chips) 
Seat 9: 99cards (2048 in chips) 
gits1980: posts the ante 25
rastamanooo: posts the ante 25
R@nTAnpl@N: posts the ante 25
Fakhish: posts the ante 25
mecco: posts the ante 25
LtGrimms: posts the ante 25
Adios89: posts the ante 25
99cards: posts the ante 25
mecco: posts small blind 100
LtGrimms: posts big blind 200
*** HOLE CARDS ***
Dealt to LtGrimms [Ts 5h]
Adios89: folds 
99cards: calls 200
gits1980: folds 
rastamanooo: folds 
R@nTAnpl@N: folds 
Fakhish: raises 3128 to 3328 and is all-in
mecco: folds 
LtGrimms: folds 
99cards: folds 
Uncalled bet (3128) returned to Fakhish
Fakhish collected 900 from pot
*** SUMMARY ***
Total pot 900 | Rake 0 
Seat 1: gits1980 folded before Flop (didn't bet)
Seat 2: rastamanooo folded before Flop (didn't bet)
Seat 4: R@nTAnpl@N folded before Flop (didn't bet)
Seat 5: Fakhish (button) collected (900)
Seat 6: mecco (small blind) folded before Flop
Seat 7: LtGrimms (big blind) folded before Flop
Seat 8: Adios89 folded before Flop (didn't bet)
Seat 9: 99cards folded before Flop



PokerStars Hand #139421970470: Tournament #1292680929, $10+$1 USD Hold'em No Limit - Level X (100/200) - 2015/08/15 15:04:51 ET
Table '1292680929 17' 9-max Seat #6 is the button
Seat 1: gits1980 (1310 in chips) 
Seat 2: rastamanooo (2635 in chips) 
Seat 3: DRAGOS FCSB (7959 in chips) 
Seat 4: R@nTAnpl@N (4172 in chips) 
Seat 5: Fakhish (4028 in chips) 
Seat 6: mecco (9216 in chips) 
Seat 7: LtGrimms (5740 in chips) 
Seat 8: Adios89 (3122 in chips) 
Seat 9: 99cards (1823 in chips) 
gits1980: posts the ante 25
rastamanooo: posts the ante 25
DRAGOS FCSB: posts the ante 25
R@nTAnpl@N: posts the ante 25
Fakhish: posts the ante 25
mecco: posts the ante 25
LtGrimms: posts the ante 25
Adios89: posts the ante 25
99cards: posts the ante 25
LtGrimms: posts small blind 100
Adios89: posts big blind 200
*** HOLE CARDS ***
Dealt to LtGrimms [4c Ad]
99cards: folds 
gits1980: folds 
rastamanooo: folds 
DRAGOS FCSB: folds 
R@nTAnpl@N: folds 
Fakhish: raises 200 to 400
mecco: folds 
LtGrimms: folds 
Adios89: folds 
Uncalled bet (200) returned to Fakhish
Fakhish collected 725 from pot
*** SUMMARY ***
Total pot 725 | Rake 0 
Seat 1: gits1980 folded before Flop (didn't bet)
Seat 2: rastamanooo folded before Flop (didn't bet)
Seat 3: DRAGOS FCSB folded before Flop (didn't bet)
Seat 4: R@nTAnpl@N folded before Flop (didn't bet)
Seat 5: Fakhish collected (725)
Seat 6: mecco (button) folded before Flop (didn't bet)
Seat 7: LtGrimms (small blind) folded before Flop
Seat 8: Adios89 (big blind) folded before Flop
Seat 9: 99cards folded before Flop (didn't bet)



PokerStars Hand #139422005708: Tournament #1292680929, $10+$1 USD Hold'em No Limit - Level X (100/200) - 2015/08/15 15:05:36 ET
Table '1292680929 17' 9-max Seat #7 is the button
Seat 1: gits1980 (1285 in chips) 
Seat 2: rastamanooo (2610 in chips) 
Seat 3: DRAGOS FCSB (7934 in chips) 
Seat 4: R@nTAnpl@N (4147 in chips) 
Seat 5: Fakhish (4528 in chips) 
Seat 6: mecco (9191 in chips) 
Seat 7: LtGrimms (5615 in chips) 
Seat 8: Adios89 (2897 in chips) 
Seat 9: 99cards (1798 in chips) 
gits1980: posts the ante 25
rastamanooo: posts the ante 25
DRAGOS FCSB: posts the ante 25
R@nTAnpl@N: posts the ante 25
Fakhish: posts the ante 25
mecco: posts the ante 25
LtGrimms: posts the ante 25
Adios89: posts the ante 25
99cards: posts the ante 25
Adios89: posts small blind 100
99cards: posts big blind 200
*** HOLE CARDS ***
Dealt to LtGrimms [Td Ts]
gits1980: folds 
rastamanooo: raises 2385 to 2585 and is all-in
DRAGOS FCSB: folds 
R@nTAnpl@N: folds 
Fakhish: folds 
mecco: folds 
LtGrimms: raises 3005 to 5590 and is all-in
Adios89: folds 
99cards: folds 
Uncalled bet (3005) returned to LtGrimms
*** FLOP *** [Qs As Kd]
*** TURN *** [Qs As Kd] [4h]
*** RIVER *** [Qs As Kd 4h] [Ks]
*** SHOW DOWN ***
rastamanooo: shows [7c 7d] (two pair, Kings and Sevens)
LtGrimms: shows [Td Ts] (two pair, Kings and Tens)
LtGrimms collected 5695 from pot
rastamanooo finished the tournament in 320th place
*** SUMMARY ***
Total pot 5695 | Rake 0 
Board [Qs As Kd 4h Ks]
Seat 1: gits1980 folded before Flop (didn't bet)
Seat 2: rastamanooo showed [7c 7d] and lost with two pair, Kings and Sevens
Seat 3: DRAGOS FCSB folded before Flop (didn't bet)
Seat 4: R@nTAnpl@N folded before Flop (didn't bet)
Seat 5: Fakhish folded before Flop (didn't bet)
Seat 6: mecco folded before Flop (didn't bet)
Seat 7: LtGrimms (button) showed [Td Ts] and won (5695) with two pair, Kings and Tens
Seat 8: Adios89 (small blind) folded before Flop
Seat 9: 99cards (big blind) folded before Flop



PokerStars Hand #139422036843: Tournament #1292680929, $10+$1 USD Hold'em No Limit - Level X (100/200) - 2015/08/15 15:06:16 ET
Table '1292680929 17' 9-max Seat #8 is the button
Seat 1: gits1980 (1260 in chips) 
Seat 3: DRAGOS FCSB (7909 in chips) 
Seat 4: R@nTAnpl@N (4122 in chips) 
Seat 5: Fakhish (4503 in chips) 
Seat 6: mecco (9166 in chips) 
Seat 7: LtGrimms (8700 in chips) 
Seat 8: Adios89 (2772 in chips) 
Seat 9: 99cards (1573 in chips) 
gits1980: posts the ante 25
DRAGOS FCSB: posts the ante 25
R@nTAnpl@N: posts the ante 25
Fakhish: posts the ante 25
mecco: posts the ante 25
LtGrimms: posts the ante 25
Adios89: posts the ante 25
99cards: posts the ante 25
99cards: posts small blind 100
gits1980: posts big blind 200
*** HOLE CARDS ***
Dealt to LtGrimms [Qs 2c]
DRAGOS FCSB: folds 
R@nTAnpl@N: folds 
Fakhish: folds 
mecco: folds 
LtGrimms: folds 
Adios89: folds 
99cards: folds 
Uncalled bet (100) returned to gits1980
gits1980 collected 400 from pot
gits1980: doesn't show hand 
*** SUMMARY ***
Total pot 400 | Rake 0 
Seat 1: gits1980 (big blind) collected (400)
Seat 3: DRAGOS FCSB folded before Flop (didn't bet)
Seat 4: R@nTAnpl@N folded before Flop (didn't bet)
Seat 5: Fakhish folded before Flop (didn't bet)
Seat 6: mecco folded before Flop (didn't bet)
Seat 7: LtGrimms folded before Flop (didn't bet)
Seat 8: Adios89 (button) folded before Flop (didn't bet)
Seat 9: 99cards (small blind) folded before Flop



PokerStars Hand #139422058342: Tournament #1292680929, $10+$1 USD Hold'em No Limit - Level X (100/200) - 2015/08/15 15:06:43 ET
Table '1292680929 17' 9-max Seat #9 is the button
Seat 1: gits1980 (1535 in chips) 
Seat 3: DRAGOS FCSB (7884 in chips) 
Seat 4: R@nTAnpl@N (4097 in chips) 
Seat 5: Fakhish (4478 in chips) 
Seat 6: mecco (9141 in chips) 
Seat 7: LtGrimms (8675 in chips) 
Seat 8: Adios89 (2747 in chips) 
Seat 9: 99cards (1448 in chips) 
gits1980: posts the ante 25
DRAGOS FCSB: posts the ante 25
R@nTAnpl@N: posts the ante 25
Fakhish: posts the ante 25
mecco: posts the ante 25
LtGrimms: posts the ante 25
Adios89: posts the ante 25
99cards: posts the ante 25
gits1980: posts small blind 100
DRAGOS FCSB: posts big blind 200
*** HOLE CARDS ***
Dealt to LtGrimms [4c 9s]
R@nTAnpl@N: folds 
Fakhish: folds 
mecco: folds 
LtGrimms: folds 
Adios89: raises 2522 to 2722 and is all-in
99cards: folds 
gits1980: folds 
DRAGOS FCSB: folds 
Uncalled bet (2522) returned to Adios89
Adios89 collected 700 from pot
*** SUMMARY ***
Total pot 700 | Rake 0 
Seat 1: gits1980 (small blind) folded before Flop
Seat 3: DRAGOS FCSB (big blind) folded before Flop
Seat 4: R@nTAnpl@N folded before Flop (didn't bet)
Seat 5: Fakhish folded before Flop (didn't bet)
Seat 6: mecco folded before Flop (didn't bet)
Seat 7: LtGrimms folded before Flop (didn't bet)
Seat 8: Adios89 collected (700)
Seat 9: 99cards (button) folded before Flop (didn't bet)



PokerStars Hand #139422079491: Tournament #1292680929, $10+$1 USD Hold'em No Limit - Level X (100/200) - 2015/08/15 15:07:10 ET
Table '1292680929 17' 9-max Seat #1 is the button
Seat 1: gits1980 (1410 in chips) 
Seat 2: FIZZE76 (7517 in chips) out of hand (moved from another table into small blind)
Seat 3: DRAGOS FCSB (7659 in chips) 
Seat 4: R@nTAnpl@N (4072 in chips) 
Seat 5: Fakhish (4453 in chips) 
Seat 6: mecco (9116 in chips) 
Seat 7: LtGrimms (8650 in chips) 
Seat 8: Adios89 (3222 in chips) 
Seat 9: 99cards (1423 in chips) 
gits1980: posts the ante 25
DRAGOS FCSB: posts the ante 25
R@nTAnpl@N: posts the ante 25
Fakhish: posts the ante 25
mecco: posts the ante 25
LtGrimms: posts the ante 25
Adios89: posts the ante 25
99cards: posts the ante 25
DRAGOS FCSB: posts small blind 100
R@nTAnpl@N: posts big blind 200
*** HOLE CARDS ***
Dealt to LtGrimms [2d 9d]
Fakhish: raises 200 to 400
mecco: calls 400
LtGrimms: folds 
Adios89: folds 
99cards: folds 
gits1980: folds 
DRAGOS FCSB: folds 
R@nTAnpl@N: folds 
*** FLOP *** [6d Tc 4h]
Fakhish: bets 1300
mecco: folds 
Uncalled bet (1300) returned to Fakhish
Fakhish collected 1300 from pot
*** SUMMARY ***
Total pot 1300 | Rake 0 
Board [6d Tc 4h]
Seat 1: gits1980 (button) folded before Flop (didn't bet)
Seat 3: DRAGOS FCSB (small blind) folded before Flop
Seat 4: R@nTAnpl@N (big blind) folded before Flop
Seat 5: Fakhish collected (1300)
Seat 6: mecco folded on the Flop
Seat 7: LtGrimms folded before Flop (didn't bet)
Seat 8: Adios89 folded before Flop (didn't bet)
Seat 9: 99cards folded before Flop (didn't bet)



PokerStars Hand #139422116849: Tournament #1292680929, $10+$1 USD Hold'em No Limit - Level X (100/200) - 2015/08/15 15:07:58 ET
Table '1292680929 17' 9-max Seat #3 is the button
Seat 1: gits1980 (1385 in chips) 
Seat 2: FIZZE76 (7517 in chips) 
Seat 3: DRAGOS FCSB (7534 in chips) 
Seat 4: R@nTAnpl@N (3847 in chips) 
Seat 5: Fakhish (5328 in chips) 
Seat 6: mecco (8691 in chips) 
Seat 7: LtGrimms (8625 in chips) 
Seat 8: Adios89 (3197 in chips) 
Seat 9: 99cards (1398 in chips) 
gits1980: posts the ante 25
FIZZE76: posts the ante 25
DRAGOS FCSB: posts the ante 25
R@nTAnpl@N: posts the ante 25
Fakhish: posts the ante 25
mecco: posts the ante 25
LtGrimms: posts the ante 25
Adios89: posts the ante 25
99cards: posts the ante 25
R@nTAnpl@N: posts small blind 100
Fakhish: posts big blind 200
*** HOLE CARDS ***
Dealt to LtGrimms [7s Kc]
mecco: folds 
LtGrimms: folds 
Adios89: folds 
99cards: folds 
gits1980: folds 
FIZZE76: folds 
DRAGOS FCSB: folds 
R@nTAnpl@N: folds 
Uncalled bet (100) returned to Fakhish
Fakhish collected 425 from pot
*** SUMMARY ***
Total pot 425 | Rake 0 
Seat 1: gits1980 folded before Flop (didn't bet)
Seat 2: FIZZE76 folded before Flop (didn't bet)
Seat 3: DRAGOS FCSB (button) folded before Flop (didn't bet)
Seat 4: R@nTAnpl@N (small blind) folded before Flop
Seat 5: Fakhish (big blind) collected (425)
Seat 6: mecco folded before Flop (didn't bet)
Seat 7: LtGrimms folded before Flop (didn't bet)
Seat 8: Adios89 folded before Flop (didn't bet)
Seat 9: 99cards folded before Flop (didn't bet)



PokerStars Hand #139422136659: Tournament #1292680929, $10+$1 USD Hold'em No Limit - Level X (100/200) - 2015/08/15 15:08:23 ET
Table '1292680929 17' 9-max Seat #4 is the button
Seat 1: gits1980 (1360 in chips) 
Seat 2: FIZZE76 (7492 in chips) 
Seat 3: DRAGOS FCSB (7509 in chips) 
Seat 4: R@nTAnpl@N (3722 in chips) 
Seat 5: Fakhish (5628 in chips) 
Seat 6: mecco (8666 in chips) 
Seat 7: LtGrimms (8600 in chips) 
Seat 8: Adios89 (3172 in chips) 
Seat 9: 99cards (1373 in chips) 
gits1980: posts the ante 25
FIZZE76: posts the ante 25
DRAGOS FCSB: posts the ante 25
R@nTAnpl@N: posts the ante 25
Fakhish: posts the ante 25
mecco: posts the ante 25
LtGrimms: posts the ante 25
Adios89: posts the ante 25
99cards: posts the ante 25
Fakhish: posts small blind 100
mecco: posts big blind 200
*** HOLE CARDS ***
Dealt to LtGrimms [Ac 4h]
LtGrimms: folds 
Adios89: folds 
99cards: raises 1148 to 1348 and is all-in
gits1980: folds 
FIZZE76: folds 
DRAGOS FCSB: folds 
R@nTAnpl@N: folds 
Fakhish: folds 
mecco: folds 
Uncalled bet (1148) returned to 99cards
99cards collected 725 from pot
99cards: doesn't show hand 
*** SUMMARY ***
Total pot 725 | Rake 0 
Seat 1: gits1980 folded before Flop (didn't bet)
Seat 2: FIZZE76 folded before Flop (didn't bet)
Seat 3: DRAGOS FCSB folded before Flop (didn't bet)
Seat 4: R@nTAnpl@N (button) folded before Flop (didn't bet)
Seat 5: Fakhish (small blind) folded before Flop
Seat 6: mecco (big blind) folded before Flop
Seat 7: LtGrimms folded before Flop (didn't bet)
Seat 8: Adios89 folded before Flop (didn't bet)
Seat 9: 99cards collected (725)



PokerStars Hand #139422151050: Tournament #1292680929, $10+$1 USD Hold'em No Limit - Level X (100/200) - 2015/08/15 15:08:42 ET
Table '1292680929 17' 9-max Seat #5 is the button
Seat 1: gits1980 (1335 in chips) 
Seat 2: FIZZE76 (7467 in chips) 
Seat 3: DRAGOS FCSB (7484 in chips) 
Seat 4: R@nTAnpl@N (3697 in chips) 
Seat 5: Fakhish (5503 in chips) 
Seat 6: mecco (8441 in chips) 
Seat 7: LtGrimms (8575 in chips) 
Seat 8: Adios89 (3147 in chips) 
Seat 9: 99cards (1873 in chips) 
gits1980: posts the ante 25
FIZZE76: posts the ante 25
DRAGOS FCSB: posts the ante 25
R@nTAnpl@N: posts the ante 25
Fakhish: posts the ante 25
mecco: posts the ante 25
LtGrimms: posts the ante 25
Adios89: posts the ante 25
99cards: posts the ante 25
mecco: posts small blind 100
LtGrimms: posts big blind 200
*** HOLE CARDS ***
Dealt to LtGrimms [3h Ks]
Adios89: folds 
99cards: folds 
gits1980: folds 
FIZZE76: folds 
DRAGOS FCSB: folds 
R@nTAnpl@N: folds 
Fakhish: folds 
mecco: raises 200 to 400
LtGrimms: calls 200
*** FLOP *** [Kc 8d 2h]
mecco: checks 
LtGrimms: bets 512
mecco: raises 888 to 1400
LtGrimms: folds [Ks]
Uncalled bet (888) returned to mecco
mecco collected 2049 from pot
mecco: doesn't show hand 
*** SUMMARY ***
Total pot 2049 | Rake 0 
Board [Kc 8d 2h]
Seat 1: gits1980 folded before Flop (didn't bet)
Seat 2: FIZZE76 folded before Flop (didn't bet)
Seat 3: DRAGOS FCSB folded before Flop (didn't bet)
Seat 4: R@nTAnpl@N folded before Flop (didn't bet)
Seat 5: Fakhish (button) folded before Flop (didn't bet)
Seat 6: mecco (small blind) collected (2049)
Seat 7: LtGrimms (big blind) folded on the Flop
Seat 8: Adios89 folded before Flop (didn't bet)
Seat 9: 99cards folded before Flop (didn't bet)



PokerStars Hand #139422191558: Tournament #1292680929, $10+$1 USD Hold'em No Limit - Level XI (125/250) - 2015/08/15 15:09:33 ET
Table '1292680929 17' 9-max Seat #6 is the button
Seat 1: gits1980 (1310 in chips) 
Seat 2: FIZZE76 (7442 in chips) 
Seat 3: DRAGOS FCSB (7459 in chips) 
Seat 4: R@nTAnpl@N (3672 in chips) 
Seat 5: Fakhish (5478 in chips) 
Seat 6: mecco (9553 in chips) 
Seat 7: LtGrimms (7638 in chips) 
Seat 8: Adios89 (3122 in chips) 
Seat 9: 99cards (1848 in chips) 
gits1980: posts the ante 30
FIZZE76: posts the ante 30
DRAGOS FCSB: posts the ante 30
R@nTAnpl@N: posts the ante 30
Fakhish: posts the ante 30
mecco: posts the ante 30
LtGrimms: posts the ante 30
Adios89: posts the ante 30
99cards: posts the ante 30
LtGrimms: posts small blind 125
Adios89: posts big blind 250
*** HOLE CARDS ***
Dealt to LtGrimms [7h Kh]
99cards: folds 
gits1980: folds 
FIZZE76: folds 
DRAGOS FCSB: folds 
R@nTAnpl@N: folds 
Fakhish: folds 
mecco: folds 
LtGrimms: raises 250 to 500
Adios89: raises 2592 to 3092 and is all-in
LtGrimms: folds 
Uncalled bet (2592) returned to Adios89
Adios89 collected 1270 from pot
*** SUMMARY ***
Total pot 1270 | Rake 0 
Seat 1: gits1980 folded before Flop (didn't bet)
Seat 2: FIZZE76 folded before Flop (didn't bet)
Seat 3: DRAGOS FCSB folded before Flop (didn't bet)
Seat 4: R@nTAnpl@N folded before Flop (didn't bet)
Seat 5: Fakhish folded before Flop (didn't bet)
Seat 6: mecco (button) folded before Flop (didn't bet)
Seat 7: LtGrimms (small blind) folded before Flop
Seat 8: Adios89 (big blind) collected (1270)
Seat 9: 99cards folded before Flop (didn't bet)



PokerStars Hand #139422221090: Tournament #1292680929, $10+$1 USD Hold'em No Limit - Level XI (125/250) - 2015/08/15 15:10:11 ET
Table '1292680929 17' 9-max Seat #7 is the button
Seat 1: gits1980 (1280 in chips) 
Seat 2: FIZZE76 (7412 in chips) 
Seat 3: DRAGOS FCSB (7429 in chips) 
Seat 4: R@nTAnpl@N (3642 in chips) 
Seat 5: Fakhish (5448 in chips) 
Seat 6: mecco (9523 in chips) 
Seat 7: LtGrimms (7108 in chips) 
Seat 8: Adios89 (3862 in chips) 
Seat 9: 99cards (1818 in chips) 
gits1980: posts the ante 30
FIZZE76: posts the ante 30
DRAGOS FCSB: posts the ante 30
R@nTAnpl@N: posts the ante 30
Fakhish: posts the ante 30
mecco: posts the ante 30
LtGrimms: posts the ante 30
Adios89: posts the ante 30
99cards: posts the ante 30
Adios89: posts small blind 125
99cards: posts big blind 250
*** HOLE CARDS ***
Dealt to LtGrimms [6c Ah]
gits1980: folds 
FIZZE76: folds 
DRAGOS FCSB: folds 
R@nTAnpl@N: raises 250 to 500
Fakhish: folds 
mecco: calls 500
LtGrimms: folds 
Adios89: folds 
99cards: calls 250
*** FLOP *** [Kh 2d 5d]
99cards: bets 1288 and is all-in
R@nTAnpl@N: calls 1288
mecco: folds 
*** TURN *** [Kh 2d 5d] [3h]
*** RIVER *** [Kh 2d 5d 3h] [9h]
*** SHOW DOWN ***
99cards: shows [Kc 8h] (a pair of Kings)
R@nTAnpl@N: shows [Js Kd] (a pair of Kings - Jack kicker)
R@nTAnpl@N collected 4471 from pot
99cards finished the tournament in 290th place
*** SUMMARY ***
Total pot 4471 | Rake 0 
Board [Kh 2d 5d 3h 9h]
Seat 1: gits1980 folded before Flop (didn't bet)
Seat 2: FIZZE76 folded before Flop (didn't bet)
Seat 3: DRAGOS FCSB folded before Flop (didn't bet)
Seat 4: R@nTAnpl@N showed [Js Kd] and won (4471) with a pair of Kings
Seat 5: Fakhish folded before Flop (didn't bet)
Seat 6: mecco folded on the Flop
Seat 7: LtGrimms (button) folded before Flop (didn't bet)
Seat 8: Adios89 (small blind) folded before Flop
Seat 9: 99cards (big blind) showed [Kc 8h] and lost with a pair of Kings



PokerStars Hand #139422292143: Tournament #1292680929, $10+$1 USD Hold'em No Limit - Level XI (125/250) - 2015/08/15 15:11:42 ET
Table '1292680929 17' 9-max Seat #8 is the button
Seat 1: gits1980 (1250 in chips) 
Seat 2: FIZZE76 (7382 in chips) 
Seat 3: DRAGOS FCSB (7399 in chips) 
Seat 4: R@nTAnpl@N (6295 in chips) 
Seat 5: Fakhish (5418 in chips) 
Seat 6: mecco (8993 in chips) 
Seat 7: LtGrimms (7078 in chips) 
Seat 8: Adios89 (3707 in chips) 
gits1980: posts the ante 30
FIZZE76: posts the ante 30
DRAGOS FCSB: posts the ante 30
R@nTAnpl@N: posts the ante 30
Fakhish: posts the ante 30
mecco: posts the ante 30
LtGrimms: posts the ante 30
Adios89: posts the ante 30
gits1980: posts small blind 125
FIZZE76: posts big blind 250
*** HOLE CARDS ***
Dealt to LtGrimms [6h 7c]
DRAGOS FCSB: raises 250 to 500
R@nTAnpl@N: folds 
Fakhish: folds 
mecco: folds 
LtGrimms: folds 
Adios89: folds 
gits1980: folds 
FIZZE76: calls 250
*** FLOP *** [5c 5h Kc]
FIZZE76: checks 
DRAGOS FCSB: bets 682
FIZZE76: folds 
Uncalled bet (682) returned to DRAGOS FCSB
DRAGOS FCSB collected 1365 from pot
DRAGOS FCSB: doesn't show hand 
*** SUMMARY ***
Total pot 1365 | Rake 0 
Board [5c 5h Kc]
Seat 1: gits1980 (small blind) folded before Flop
Seat 2: FIZZE76 (big blind) folded on the Flop
Seat 3: DRAGOS FCSB collected (1365)
Seat 4: R@nTAnpl@N folded before Flop (didn't bet)
Seat 5: Fakhish folded before Flop (didn't bet)
Seat 6: mecco folded before Flop (didn't bet)
Seat 7: LtGrimms folded before Flop (didn't bet)
Seat 8: Adios89 (button) folded before Flop (didn't bet)



PokerStars Hand #139422339802: Tournament #1292680929, $10+$1 USD Hold'em No Limit - Level XI (125/250) - 2015/08/15 15:12:43 ET
Table '1292680929 17' 9-max Seat #1 is the button
Seat 1: gits1980 (1095 in chips) 
Seat 2: FIZZE76 (6852 in chips) 
Seat 3: DRAGOS FCSB (8234 in chips) 
Seat 4: R@nTAnpl@N (6265 in chips) 
Seat 5: Fakhish (5388 in chips) 
Seat 6: mecco (8963 in chips) 
Seat 7: LtGrimms (7048 in chips) 
Seat 8: Adios89 (3677 in chips) 
Seat 9: MoKoZoBa (7407 in chips) 
gits1980: posts the ante 30
FIZZE76: posts the ante 30
DRAGOS FCSB: posts the ante 30
R@nTAnpl@N: posts the ante 30
Fakhish: posts the ante 30
mecco: posts the ante 30
LtGrimms: posts the ante 30
Adios89: posts the ante 30
MoKoZoBa: posts the ante 30
FIZZE76: posts small blind 125
DRAGOS FCSB: posts big blind 250
*** HOLE CARDS ***
Dealt to LtGrimms [5h As]
R@nTAnpl@N: folds 
Fakhish: folds 
mecco: folds 
LtGrimms: raises 300 to 550
Adios89: folds 
MoKoZoBa: folds 
gits1980: folds 
FIZZE76: folds 
DRAGOS FCSB: folds 
Uncalled bet (300) returned to LtGrimms
LtGrimms collected 895 from pot
*** SUMMARY ***
Total pot 895 | Rake 0 
Seat 1: gits1980 (button) folded before Flop (didn't bet)
Seat 2: FIZZE76 (small blind) folded before Flop
Seat 3: DRAGOS FCSB (big blind) folded before Flop
Seat 4: R@nTAnpl@N folded before Flop (didn't bet)
Seat 5: Fakhish folded before Flop (didn't bet)
Seat 6: mecco folded before Flop (didn't bet)
Seat 7: LtGrimms collected (895)
Seat 8: Adios89 folded before Flop (didn't bet)
Seat 9: MoKoZoBa folded before Flop (didn't bet)



PokerStars Hand #139422359215: Tournament #1292680929, $10+$1 USD Hold'em No Limit - Level XI (125/250) - 2015/08/15 15:13:08 ET
Table '1292680929 17' 9-max Seat #2 is the button
Seat 1: gits1980 (1065 in chips) 
Seat 2: FIZZE76 (6697 in chips) 
Seat 3: DRAGOS FCSB (7954 in chips) 
Seat 4: R@nTAnpl@N (6235 in chips) 
Seat 5: Fakhish (5358 in chips) 
Seat 6: mecco (8933 in chips) 
Seat 7: LtGrimms (7663 in chips) 
Seat 8: Adios89 (3647 in chips) 
Seat 9: MoKoZoBa (7377 in chips) 
gits1980: posts the ante 30
FIZZE76: posts the ante 30
DRAGOS FCSB: posts the ante 30
R@nTAnpl@N: posts the ante 30
Fakhish: posts the ante 30
mecco: posts the ante 30
LtGrimms: posts the ante 30
Adios89: posts the ante 30
MoKoZoBa: posts the ante 30
DRAGOS FCSB: posts small blind 125
R@nTAnpl@N: posts big blind 250
*** HOLE CARDS ***
Dealt to LtGrimms [8d Ad]
Fakhish: folds 
mecco: folds 
LtGrimms: raises 300 to 550
Adios89: folds 
MoKoZoBa: folds 
gits1980: folds 
FIZZE76: folds 
DRAGOS FCSB: folds 
R@nTAnpl@N: folds 
Uncalled bet (300) returned to LtGrimms
LtGrimms collected 895 from pot
*** SUMMARY ***
Total pot 895 | Rake 0 
Seat 1: gits1980 folded before Flop (didn't bet)
Seat 2: FIZZE76 (button) folded before Flop (didn't bet)
Seat 3: DRAGOS FCSB (small blind) folded before Flop
Seat 4: R@nTAnpl@N (big blind) folded before Flop
Seat 5: Fakhish folded before Flop (didn't bet)
Seat 6: mecco folded before Flop (didn't bet)
Seat 7: LtGrimms collected (895)
Seat 8: Adios89 folded before Flop (didn't bet)
Seat 9: MoKoZoBa folded before Flop (didn't bet)



PokerStars Hand #139422382707: Tournament #1292680929, $10+$1 USD Hold'em No Limit - Level XI (125/250) - 2015/08/15 15:13:39 ET
Table '1292680929 17' 9-max Seat #3 is the button
Seat 1: gits1980 (1035 in chips) 
Seat 2: FIZZE76 (6667 in chips) 
Seat 3: DRAGOS FCSB (7799 in chips) 
Seat 4: R@nTAnpl@N (5955 in chips) 
Seat 5: Fakhish (5328 in chips) 
Seat 6: mecco (8903 in chips) 
Seat 7: LtGrimms (8278 in chips) 
Seat 8: Adios89 (3617 in chips) 
Seat 9: MoKoZoBa (7347 in chips) 
gits1980: posts the ante 30
FIZZE76: posts the ante 30
DRAGOS FCSB: posts the ante 30
R@nTAnpl@N: posts the ante 30
Fakhish: posts the ante 30
mecco: posts the ante 30
LtGrimms: posts the ante 30
Adios89: posts the ante 30
MoKoZoBa: posts the ante 30
R@nTAnpl@N: posts small blind 125
Fakhish: posts big blind 250
*** HOLE CARDS ***
Dealt to LtGrimms [9d 2s]
mecco: folds 
LtGrimms: folds 
Adios89: folds 
MoKoZoBa: folds 
gits1980: folds 
FIZZE76: folds 
DRAGOS FCSB: raises 250 to 500
R@nTAnpl@N: folds 
Fakhish: folds 
Uncalled bet (250) returned to DRAGOS FCSB
DRAGOS FCSB collected 895 from pot
DRAGOS FCSB: doesn't show hand 
*** SUMMARY ***
Total pot 895 | Rake 0 
Seat 1: gits1980 folded before Flop (didn't bet)
Seat 2: FIZZE76 folded before Flop (didn't bet)
Seat 3: DRAGOS FCSB (button) collected (895)
Seat 4: R@nTAnpl@N (small blind) folded before Flop
Seat 5: Fakhish (big blind) folded before Flop
Seat 6: mecco folded before Flop (didn't bet)
Seat 7: LtGrimms folded before Flop (didn't bet)
Seat 8: Adios89 folded before Flop (didn't bet)
Seat 9: MoKoZoBa folded before Flop (didn't bet)



PokerStars Hand #139422428537: Tournament #1292680929, $10+$1 USD Hold'em No Limit - Level XI (125/250) - 2015/08/15 15:14:38 ET
Table '1292680929 17' 9-max Seat #4 is the button
Seat 1: gits1980 (1005 in chips) 
Seat 2: FIZZE76 (6637 in chips) 
Seat 3: DRAGOS FCSB (8414 in chips) 
Seat 4: R@nTAnpl@N (5800 in chips) 
Seat 5: Fakhish (5048 in chips) 
Seat 6: mecco (8873 in chips) 
Seat 7: LtGrimms (8248 in chips) 
Seat 8: Adios89 (3587 in chips) 
Seat 9: MoKoZoBa (7317 in chips) 
gits1980: posts the ante 30
FIZZE76: posts the ante 30
DRAGOS FCSB: posts the ante 30
R@nTAnpl@N: posts the ante 30
Fakhish: posts the ante 30
mecco: posts the ante 30
LtGrimms: posts the ante 30
Adios89: posts the ante 30
MoKoZoBa: posts the ante 30
Fakhish: posts small blind 125
mecco: posts big blind 250
*** HOLE CARDS ***
Dealt to LtGrimms [3h Js]
LtGrimms: folds 
Adios89: folds 
MoKoZoBa: folds 
gits1980: folds 
FIZZE76: raises 379 to 629
DRAGOS FCSB: folds 
R@nTAnpl@N: folds 
Fakhish: folds 
mecco: folds 
Uncalled bet (379) returned to FIZZE76
FIZZE76 collected 895 from pot
FIZZE76: doesn't show hand 
*** SUMMARY ***
Total pot 895 | Rake 0 
Seat 1: gits1980 folded before Flop (didn't bet)
Seat 2: FIZZE76 collected (895)
Seat 3: DRAGOS FCSB folded before Flop (didn't bet)
Seat 4: R@nTAnpl@N (button) folded before Flop (didn't bet)
Seat 5: Fakhish (small blind) folded before Flop
Seat 6: mecco (big blind) folded before Flop
Seat 7: LtGrimms folded before Flop (didn't bet)
Seat 8: Adios89 folded before Flop (didn't bet)
Seat 9: MoKoZoBa folded before Flop (didn't bet)



PokerStars Hand #139422448360: Tournament #1292680929, $10+$1 USD Hold'em No Limit - Level XI (125/250) - 2015/08/15 15:15:04 ET
Table '1292680929 17' 9-max Seat #5 is the button
Seat 1: gits1980 (975 in chips) 
Seat 2: FIZZE76 (7252 in chips) 
Seat 3: DRAGOS FCSB (8384 in chips) 
Seat 4: R@nTAnpl@N (5770 in chips) 
Seat 5: Fakhish (4893 in chips) 
Seat 6: mecco (8593 in chips) 
Seat 7: LtGrimms (8218 in chips) 
Seat 8: Adios89 (3557 in chips) 
Seat 9: MoKoZoBa (7287 in chips) 
gits1980: posts the ante 30
FIZZE76: posts the ante 30
DRAGOS FCSB: posts the ante 30
R@nTAnpl@N: posts the ante 30
Fakhish: posts the ante 30
mecco: posts the ante 30
LtGrimms: posts the ante 30
Adios89: posts the ante 30
MoKoZoBa: posts the ante 30
mecco: posts small blind 125
LtGrimms: posts big blind 250
*** HOLE CARDS ***
Dealt to LtGrimms [Qs Td]
Adios89: folds 
MoKoZoBa: folds 
gits1980: raises 695 to 945 and is all-in
FIZZE76: folds 
DRAGOS FCSB: folds 
R@nTAnpl@N: folds 
Fakhish: folds 
mecco: folds 
LtGrimms: folds 
Uncalled bet (695) returned to gits1980
gits1980 collected 895 from pot
gits1980: doesn't show hand 
*** SUMMARY ***
Total pot 895 | Rake 0 
Seat 1: gits1980 collected (895)
Seat 2: FIZZE76 folded before Flop (didn't bet)
Seat 3: DRAGOS FCSB folded before Flop (didn't bet)
Seat 4: R@nTAnpl@N folded before Flop (didn't bet)
Seat 5: Fakhish (button) folded before Flop (didn't bet)
Seat 6: mecco (small blind) folded before Flop
Seat 7: LtGrimms (big blind) folded before Flop
Seat 8: Adios89 folded before Flop (didn't bet)
Seat 9: MoKoZoBa folded before Flop (didn't bet)



PokerStars Hand #139422488396: Tournament #1292680929, $10+$1 USD Hold'em No Limit - Level XI (125/250) - 2015/08/15 15:15:55 ET
Table '1292680929 17' 9-max Seat #6 is the button
Seat 1: gits1980 (1590 in chips) 
Seat 2: FIZZE76 (7222 in chips) 
Seat 3: DRAGOS FCSB (8354 in chips) 
Seat 4: R@nTAnpl@N (5740 in chips) 
Seat 5: Fakhish (4863 in chips) 
Seat 6: mecco (8438 in chips) 
Seat 7: LtGrimms (7938 in chips) 
Seat 8: Adios89 (3527 in chips) 
Seat 9: MoKoZoBa (7257 in chips) 
gits1980: posts the ante 30
FIZZE76: posts the ante 30
DRAGOS FCSB: posts the ante 30
R@nTAnpl@N: posts the ante 30
Fakhish: posts the ante 30
mecco: posts the ante 30
LtGrimms: posts the ante 30
Adios89: posts the ante 30
MoKoZoBa: posts the ante 30
LtGrimms: posts small blind 125
Adios89: posts big blind 250
*** HOLE CARDS ***
Dealt to LtGrimms [6d 4c]
MoKoZoBa: folds 
gits1980: folds 
FIZZE76: folds 
DRAGOS FCSB: folds 
R@nTAnpl@N: raises 272 to 522
Fakhish: folds 
mecco: raises 978 to 1500
LtGrimms: folds 
Adios89: folds 
R@nTAnpl@N: raises 4210 to 5710 and is all-in
mecco: calls 4210
*** FLOP *** [4s Jc Tc]
*** TURN *** [4s Jc Tc] [Td]
*** RIVER *** [4s Jc Tc Td] [8c]
*** SHOW DOWN ***
R@nTAnpl@N: shows [Th Ts] (four of a kind, Tens)
mecco: shows [Qc Ks] (a pair of Tens)
R@nTAnpl@N collected 12065 from pot
*** SUMMARY ***
Total pot 12065 | Rake 0 
Board [4s Jc Tc Td 8c]
Seat 1: gits1980 folded before Flop (didn't bet)
Seat 2: FIZZE76 folded before Flop (didn't bet)
Seat 3: DRAGOS FCSB folded before Flop (didn't bet)
Seat 4: R@nTAnpl@N showed [Th Ts] and won (12065) with four of a kind, Tens
Seat 5: Fakhish folded before Flop (didn't bet)
Seat 6: mecco (button) showed [Qc Ks] and lost with a pair of Tens
Seat 7: LtGrimms (small blind) folded before Flop
Seat 8: Adios89 (big blind) folded before Flop
Seat 9: MoKoZoBa folded before Flop (didn't bet)



PokerStars Hand #139422552178: Tournament #1292680929, $10+$1 USD Hold'em No Limit - Level XI (125/250) - 2015/08/15 15:17:17 ET
Table '1292680929 17' 9-max Seat #7 is the button
Seat 1: gits1980 (1560 in chips) 
Seat 2: FIZZE76 (7192 in chips) 
Seat 3: DRAGOS FCSB (8324 in chips) 
Seat 4: R@nTAnpl@N (12065 in chips) 
Seat 5: Fakhish (4833 in chips) 
Seat 6: mecco (2698 in chips) 
Seat 7: LtGrimms (7783 in chips) 
Seat 8: Adios89 (3247 in chips) 
Seat 9: MoKoZoBa (7227 in chips) 
gits1980: posts the ante 30
FIZZE76: posts the ante 30
DRAGOS FCSB: posts the ante 30
R@nTAnpl@N: posts the ante 30
Fakhish: posts the ante 30
mecco: posts the ante 30
LtGrimms: posts the ante 30
Adios89: posts the ante 30
MoKoZoBa: posts the ante 30
Adios89: posts small blind 125
MoKoZoBa: posts big blind 250
*** HOLE CARDS ***
Dealt to LtGrimms [6d Ts]
gits1980: folds 
FIZZE76: folds 
DRAGOS FCSB: folds 
R@nTAnpl@N: folds 
Fakhish: folds 
mecco: folds 
LtGrimms: raises 250 to 500
Adios89: folds 
MoKoZoBa: folds 
Uncalled bet (250) returned to LtGrimms
LtGrimms collected 895 from pot
*** SUMMARY ***
Total pot 895 | Rake 0 
Seat 1: gits1980 folded before Flop (didn't bet)
Seat 2: FIZZE76 folded before Flop (didn't bet)
Seat 3: DRAGOS FCSB folded before Flop (didn't bet)
Seat 4: R@nTAnpl@N folded before Flop (didn't bet)
Seat 5: Fakhish folded before Flop (didn't bet)
Seat 6: mecco folded before Flop (didn't bet)
Seat 7: LtGrimms (button) collected (895)
Seat 8: Adios89 (small blind) folded before Flop
Seat 9: MoKoZoBa (big blind) folded before Flop



PokerStars Hand #139422591615: Tournament #1292680929, $10+$1 USD Hold'em No Limit - Level XI (125/250) - 2015/08/15 15:18:07 ET
Table '1292680929 17' 9-max Seat #8 is the button
Seat 1: gits1980 (1530 in chips) 
Seat 2: FIZZE76 (7162 in chips) 
Seat 3: DRAGOS FCSB (8294 in chips) 
Seat 4: R@nTAnpl@N (12035 in chips) 
Seat 5: Fakhish (4803 in chips) 
Seat 6: mecco (2668 in chips) 
Seat 7: LtGrimms (8398 in chips) 
Seat 8: Adios89 (3092 in chips) 
Seat 9: MoKoZoBa (6947 in chips) 
gits1980: posts the ante 30
FIZZE76: posts the ante 30
DRAGOS FCSB: posts the ante 30
R@nTAnpl@N: posts the ante 30
Fakhish: posts the ante 30
mecco: posts the ante 30
LtGrimms: posts the ante 30
Adios89: posts the ante 30
MoKoZoBa: posts the ante 30
MoKoZoBa: posts small blind 125
gits1980: posts big blind 250
*** HOLE CARDS ***
Dealt to LtGrimms [Js 9s]
FIZZE76: folds 
DRAGOS FCSB: folds 
R@nTAnpl@N: folds 
Fakhish: raises 250 to 500
mecco: calls 500
LtGrimms: folds 
Adios89: raises 2562 to 3062 and is all-in
MoKoZoBa: folds 
gits1980: folds 
Fakhish: folds 
mecco: calls 2138 and is all-in
Uncalled bet (424) returned to Adios89
*** FLOP *** [9h Tc 3d]
*** TURN *** [9h Tc 3d] [4s]
*** RIVER *** [9h Tc 3d 4s] [6d]
*** SHOW DOWN ***
mecco: shows [7c Ks] (high card King)
Adios89: shows [Kh Kd] (a pair of Kings)
Adios89 collected 6421 from pot
mecco finished the tournament in 256th place
*** SUMMARY ***
Total pot 6421 | Rake 0 
Board [9h Tc 3d 4s 6d]
Seat 1: gits1980 (big blind) folded before Flop
Seat 2: FIZZE76 folded before Flop (didn't bet)
Seat 3: DRAGOS FCSB folded before Flop (didn't bet)
Seat 4: R@nTAnpl@N folded before Flop (didn't bet)
Seat 5: Fakhish folded before Flop
Seat 6: mecco showed [7c Ks] and lost with high card King
Seat 7: LtGrimms folded before Flop (didn't bet)
Seat 8: Adios89 (button) showed [Kh Kd] and won (6421) with a pair of Kings
Seat 9: MoKoZoBa (small blind) folded before Flop



PokerStars Hand #139422637309: Tournament #1292680929, $10+$1 USD Hold'em No Limit - Level XII (150/300) - 2015/08/15 15:19:04 ET
Table '1292680929 17' 9-max Seat #9 is the button
Seat 1: gits1980 (1250 in chips) 
Seat 2: FIZZE76 (7132 in chips) 
Seat 3: DRAGOS FCSB (8264 in chips) 
Seat 4: R@nTAnpl@N (12005 in chips) 
Seat 5: Fakhish (4273 in chips) 
Seat 7: LtGrimms (8368 in chips) 
Seat 8: Adios89 (6845 in chips) 
Seat 9: MoKoZoBa (6792 in chips) 
gits1980: posts the ante 40
FIZZE76: posts the ante 40
DRAGOS FCSB: posts the ante 40
R@nTAnpl@N: posts the ante 40
Fakhish: posts the ante 40
LtGrimms: posts the ante 40
Adios89: posts the ante 40
MoKoZoBa: posts the ante 40
gits1980: posts small blind 150
FIZZE76: posts big blind 300
*** HOLE CARDS ***
Dealt to LtGrimms [7h 4h]
DRAGOS FCSB: folds 
R@nTAnpl@N: folds 
Fakhish: folds 
LtGrimms: folds 
Adios89: folds 
MoKoZoBa: folds 
gits1980: folds 
Uncalled bet (150) returned to FIZZE76
FIZZE76 collected 620 from pot
FIZZE76: doesn't show hand 
*** SUMMARY ***
Total pot 620 | Rake 0 
Seat 1: gits1980 (small blind) folded before Flop
Seat 2: FIZZE76 (big blind) collected (620)
Seat 3: DRAGOS FCSB folded before Flop (didn't bet)
Seat 4: R@nTAnpl@N folded before Flop (didn't bet)
Seat 5: Fakhish folded before Flop (didn't bet)
Seat 7: LtGrimms folded before Flop (didn't bet)
Seat 8: Adios89 folded before Flop (didn't bet)
Seat 9: MoKoZoBa (button) folded before Flop (didn't bet)



PokerStars Hand #139422653424: Tournament #1292680929, $10+$1 USD Hold'em No Limit - Level XII (150/300) - 2015/08/15 15:19:25 ET
Table '1292680929 17' 9-max Seat #1 is the button
Seat 1: gits1980 (1060 in chips) 
Seat 2: FIZZE76 (7562 in chips) 
Seat 3: DRAGOS FCSB (8224 in chips) 
Seat 4: R@nTAnpl@N (11965 in chips) 
Seat 5: Fakhish (4233 in chips) 
Seat 7: LtGrimms (8328 in chips) 
Seat 8: Adios89 (6805 in chips) 
Seat 9: MoKoZoBa (6752 in chips) 
gits1980: posts the ante 40
FIZZE76: posts the ante 40
DRAGOS FCSB: posts the ante 40
R@nTAnpl@N: posts the ante 40
Fakhish: posts the ante 40
LtGrimms: posts the ante 40
Adios89: posts the ante 40
MoKoZoBa: posts the ante 40
FIZZE76: posts small blind 150
DRAGOS FCSB: posts big blind 300
*** HOLE CARDS ***
Dealt to LtGrimms [6c 7d]
R@nTAnpl@N: folds 
Fakhish: folds 
LtGrimms: folds 
Adios89: folds 
MoKoZoBa: folds 
gits1980: folds 
FIZZE76: folds 
Uncalled bet (150) returned to DRAGOS FCSB
DRAGOS FCSB collected 620 from pot
DRAGOS FCSB: doesn't show hand 
*** SUMMARY ***
Total pot 620 | Rake 0 
Seat 1: gits1980 (button) folded before Flop (didn't bet)
Seat 2: FIZZE76 (small blind) folded before Flop
Seat 3: DRAGOS FCSB (big blind) collected (620)
Seat 4: R@nTAnpl@N folded before Flop (didn't bet)
Seat 5: Fakhish folded before Flop (didn't bet)
Seat 7: LtGrimms folded before Flop (didn't bet)
Seat 8: Adios89 folded before Flop (didn't bet)
Seat 9: MoKoZoBa folded before Flop (didn't bet)



PokerStars Hand #139422707125: Tournament #1292680929, $10+$1 USD Hold'em No Limit - Level XII (150/300) - 2015/08/15 15:20:33 ET
Table '1292680929 17' 9-max Seat #2 is the button
Seat 1: gits1980 (1020 in chips) 
Seat 2: FIZZE76 (7372 in chips) 
Seat 3: DRAGOS FCSB (8654 in chips) 
Seat 4: R@nTAnpl@N (11925 in chips) 
Seat 5: Fakhish (4193 in chips) 
Seat 6: rubavitoc (1697 in chips) 
Seat 7: LtGrimms (8288 in chips) 
Seat 8: Adios89 (6765 in chips) 
Seat 9: MoKoZoBa (6712 in chips) 
gits1980: posts the ante 40
FIZZE76: posts the ante 40
DRAGOS FCSB: posts the ante 40
R@nTAnpl@N: posts the ante 40
Fakhish: posts the ante 40
rubavitoc: posts the ante 40
LtGrimms: posts the ante 40
Adios89: posts the ante 40
MoKoZoBa: posts the ante 40
DRAGOS FCSB: posts small blind 150
R@nTAnpl@N: posts big blind 300
*** HOLE CARDS ***
Dealt to LtGrimms [Kd Ks]
Fakhish: folds 
rubavitoc: folds 
LtGrimms: raises 300 to 600
Adios89: folds 
MoKoZoBa: folds 
gits1980: raises 380 to 980 and is all-in
FIZZE76: calls 980
DRAGOS FCSB: folds 
R@nTAnpl@N: folds 
LtGrimms: raises 2020 to 3000
FIZZE76: folds 
Uncalled bet (2020) returned to LtGrimms
*** FLOP *** [Jc 5c 2c]
*** TURN *** [Jc 5c 2c] [6s]
*** RIVER *** [Jc 5c 2c 6s] [8h]
*** SHOW DOWN ***
LtGrimms: shows [Kd Ks] (a pair of Kings)
gits1980: shows [9d Ah] (high card Ace)
LtGrimms collected 3750 from pot
gits1980 finished the tournament in 240th place
*** SUMMARY ***
Total pot 3750 | Rake 0 
Board [Jc 5c 2c 6s 8h]
Seat 1: gits1980 showed [9d Ah] and lost with high card Ace
Seat 2: FIZZE76 (button) folded before Flop
Seat 3: DRAGOS FCSB (small blind) folded before Flop
Seat 4: R@nTAnpl@N (big blind) folded before Flop
Seat 5: Fakhish folded before Flop (didn't bet)
Seat 6: rubavitoc folded before Flop (didn't bet)
Seat 7: LtGrimms showed [Kd Ks] and won (3750) with a pair of Kings
Seat 8: Adios89 folded before Flop (didn't bet)
Seat 9: MoKoZoBa folded before Flop (didn't bet)



PokerStars Hand #139422752766: Tournament #1292680929, $10+$1 USD Hold'em No Limit - Level XII (150/300) - 2015/08/15 15:21:32 ET
Table '1292680929 17' 9-max Seat #3 is the button
Seat 2: FIZZE76 (6352 in chips) 
Seat 3: DRAGOS FCSB (8464 in chips) 
Seat 4: R@nTAnpl@N (11585 in chips) 
Seat 5: Fakhish (4153 in chips) 
Seat 6: rubavitoc (1657 in chips) 
Seat 7: LtGrimms (11018 in chips) 
Seat 8: Adios89 (6725 in chips) 
Seat 9: MoKoZoBa (6672 in chips) 
FIZZE76: posts the ante 40
DRAGOS FCSB: posts the ante 40
R@nTAnpl@N: posts the ante 40
Fakhish: posts the ante 40
rubavitoc: posts the ante 40
LtGrimms: posts the ante 40
Adios89: posts the ante 40
MoKoZoBa: posts the ante 40
R@nTAnpl@N: posts small blind 150
Fakhish: posts big blind 300
*** HOLE CARDS ***
Dealt to LtGrimms [7c Jh]
rubavitoc: folds 
LtGrimms: folds 
Adios89: folds 
MoKoZoBa: folds 
FIZZE76: folds 
DRAGOS FCSB: raises 300 to 600
R@nTAnpl@N: raises 927 to 1527
Fakhish: folds 
DRAGOS FCSB: folds 
Uncalled bet (927) returned to R@nTAnpl@N
R@nTAnpl@N collected 1820 from pot
*** SUMMARY ***
Total pot 1820 | Rake 0 
Seat 2: FIZZE76 folded before Flop (didn't bet)
Seat 3: DRAGOS FCSB (button) folded before Flop
Seat 4: R@nTAnpl@N (small blind) collected (1820)
Seat 5: Fakhish (big blind) folded before Flop
Seat 6: rubavitoc folded before Flop (didn't bet)
Seat 7: LtGrimms folded before Flop (didn't bet)
Seat 8: Adios89 folded before Flop (didn't bet)
Seat 9: MoKoZoBa folded before Flop (didn't bet)



PokerStars Hand #139422787453: Tournament #1292680929, $10+$1 USD Hold'em No Limit - Level XII (150/300) - 2015/08/15 15:22:16 ET
Table '1292680929 17' 9-max Seat #4 is the button
Seat 2: FIZZE76 (6312 in chips) 
Seat 3: DRAGOS FCSB (7824 in chips) 
Seat 4: R@nTAnpl@N (12765 in chips) 
Seat 5: Fakhish (3813 in chips) 
Seat 6: rubavitoc (1617 in chips) 
Seat 7: LtGrimms (10978 in chips) 
Seat 8: Adios89 (6685 in chips) 
Seat 9: MoKoZoBa (6632 in chips) 
FIZZE76: posts the ante 40
DRAGOS FCSB: posts the ante 40
R@nTAnpl@N: posts the ante 40
Fakhish: posts the ante 40
rubavitoc: posts the ante 40
LtGrimms: posts the ante 40
Adios89: posts the ante 40
MoKoZoBa: posts the ante 40
Fakhish: posts small blind 150
rubavitoc: posts big blind 300
*** HOLE CARDS ***
Dealt to LtGrimms [4d 4s]
LtGrimms: folds 
Adios89: folds 
MoKoZoBa: folds 
FIZZE76: folds 
DRAGOS FCSB: folds 
R@nTAnpl@N: folds 
Fakhish: raises 600 to 900
rubavitoc: raises 677 to 1577 and is all-in
Fakhish: calls 677
*** FLOP *** [As 6d 4c]
*** TURN *** [As 6d 4c] [Th]
*** RIVER *** [As 6d 4c Th] [5s]
*** SHOW DOWN ***
Fakhish: shows [Td Ac] (two pair, Aces and Tens)
rubavitoc: shows [Qc Qd] (a pair of Queens)
Fakhish collected 3474 from pot
rubavitoc finished the tournament in 229th place
*** SUMMARY ***
Total pot 3474 | Rake 0 
Board [As 6d 4c Th 5s]
Seat 2: FIZZE76 folded before Flop (didn't bet)
Seat 3: DRAGOS FCSB folded before Flop (didn't bet)
Seat 4: R@nTAnpl@N (button) folded before Flop (didn't bet)
Seat 5: Fakhish (small blind) showed [Td Ac] and won (3474) with two pair, Aces and Tens
Seat 6: rubavitoc (big blind) showed [Qc Qd] and lost with a pair of Queens
Seat 7: LtGrimms folded before Flop (didn't bet)
Seat 8: Adios89 folded before Flop (didn't bet)
Seat 9: MoKoZoBa folded before Flop (didn't bet)



PokerStars Hand #139422814430: Tournament #1292680929, $10+$1 USD Hold'em No Limit - Level XII (150/300) - 2015/08/15 15:22:51 ET
Table '1292680929 17' 9-max Seat #5 is the button
Seat 1: jan4ik kroki (4565 in chips) 
Seat 2: FIZZE76 (6272 in chips) 
Seat 3: DRAGOS FCSB (7784 in chips) 
Seat 4: R@nTAnpl@N (12725 in chips) 
Seat 5: Fakhish (5670 in chips) 
Seat 7: LtGrimms (10938 in chips) 
Seat 8: Adios89 (6645 in chips) 
Seat 9: MoKoZoBa (6592 in chips) 
jan4ik kroki: posts the ante 40
FIZZE76: posts the ante 40
DRAGOS FCSB: posts the ante 40
R@nTAnpl@N: posts the ante 40
Fakhish: posts the ante 40
LtGrimms: posts the ante 40
Adios89: posts the ante 40
MoKoZoBa: posts the ante 40
LtGrimms: posts small blind 150
Adios89: posts big blind 300
*** HOLE CARDS ***
Dealt to LtGrimms [9c Qs]
MoKoZoBa: folds 
jan4ik kroki: folds 
FIZZE76: folds 
DRAGOS FCSB: raises 300 to 600
R@nTAnpl@N: folds 
Fakhish: folds 
LtGrimms: folds 
Adios89: folds 
Uncalled bet (300) returned to DRAGOS FCSB
DRAGOS FCSB collected 1070 from pot
DRAGOS FCSB: doesn't show hand 
*** SUMMARY ***
Total pot 1070 | Rake 0 
Seat 1: jan4ik kroki folded before Flop (didn't bet)
Seat 2: FIZZE76 folded before Flop (didn't bet)
Seat 3: DRAGOS FCSB collected (1070)
Seat 4: R@nTAnpl@N folded before Flop (didn't bet)
Seat 5: Fakhish (button) folded before Flop (didn't bet)
Seat 7: LtGrimms (small blind) folded before Flop
Seat 8: Adios89 (big blind) folded before Flop
Seat 9: MoKoZoBa folded before Flop (didn't bet)



PokerStars Hand #139422831996: Tournament #1292680929, $10+$1 USD Hold'em No Limit - Level XII (150/300) - 2015/08/15 15:23:13 ET
Table '1292680929 17' 9-max Seat #7 is the button
Seat 1: jan4ik kroki (4525 in chips) 
Seat 2: FIZZE76 (6232 in chips) 
Seat 3: DRAGOS FCSB (8514 in chips) 
Seat 4: R@nTAnpl@N (12685 in chips) 
Seat 5: Fakhish (5630 in chips) 
Seat 7: LtGrimms (10748 in chips) 
Seat 8: Adios89 (6305 in chips) 
Seat 9: MoKoZoBa (6552 in chips) 
jan4ik kroki: posts the ante 40
FIZZE76: posts the ante 40
DRAGOS FCSB: posts the ante 40
R@nTAnpl@N: posts the ante 40
Fakhish: posts the ante 40
LtGrimms: posts the ante 40
Adios89: posts the ante 40
MoKoZoBa: posts the ante 40
Adios89: posts small blind 150
MoKoZoBa: posts big blind 300
*** HOLE CARDS ***
Dealt to LtGrimms [Td Tc]
jan4ik kroki: raises 300 to 600
FIZZE76: folds 
DRAGOS FCSB: raises 750 to 1350
R@nTAnpl@N: folds 
Fakhish: folds 
LtGrimms: folds 
Adios89: folds 
MoKoZoBa: folds 
jan4ik kroki: raises 3135 to 4485 and is all-in
DRAGOS FCSB: calls 3135
*** FLOP *** [8c Kc 6h]
*** TURN *** [8c Kc 6h] [Jd]
*** RIVER *** [8c Kc 6h Jd] [9s]
*** SHOW DOWN ***
jan4ik kroki: shows [Ah Kh] (a pair of Kings)
DRAGOS FCSB: shows [Ad As] (a pair of Aces)
DRAGOS FCSB collected 9740 from pot
jan4ik kroki finished the tournament in 222nd place
*** SUMMARY ***
Total pot 9740 | Rake 0 
Board [8c Kc 6h Jd 9s]
Seat 1: jan4ik kroki showed [Ah Kh] and lost with a pair of Kings
Seat 2: FIZZE76 folded before Flop (didn't bet)
Seat 3: DRAGOS FCSB showed [Ad As] and won (9740) with a pair of Aces
Seat 4: R@nTAnpl@N folded before Flop (didn't bet)
Seat 5: Fakhish folded before Flop (didn't bet)
Seat 7: LtGrimms (button) folded before Flop (didn't bet)
Seat 8: Adios89 (small blind) folded before Flop
Seat 9: MoKoZoBa (big blind) folded before Flop



PokerStars Hand #139422866202: Tournament #1292680929, $10+$1 USD Hold'em No Limit - Level XII (150/300) - 2015/08/15 15:23:57 ET
Table '1292680929 17' 9-max Seat #8 is the button
Seat 2: FIZZE76 (6192 in chips) 
Seat 3: DRAGOS FCSB (13729 in chips) 
Seat 4: R@nTAnpl@N (12645 in chips) 
Seat 5: Fakhish (5590 in chips) 
Seat 6: zas91 (9444 in chips) 
Seat 7: LtGrimms (10708 in chips) 
Seat 8: Adios89 (6115 in chips) 
Seat 9: MoKoZoBa (6212 in chips) 
FIZZE76: posts the ante 40
DRAGOS FCSB: posts the ante 40
R@nTAnpl@N: posts the ante 40
Fakhish: posts the ante 40
zas91: posts the ante 40
LtGrimms: posts the ante 40
Adios89: posts the ante 40
MoKoZoBa: posts the ante 40
MoKoZoBa: posts small blind 150
FIZZE76: posts big blind 300
*** HOLE CARDS ***
Dealt to LtGrimms [Qh 8h]
DRAGOS FCSB: folds 
R@nTAnpl@N: folds 
Fakhish: folds 
zas91: folds 
LtGrimms: raises 300 to 600
Adios89: folds 
MoKoZoBa: calls 450
FIZZE76: folds 
*** FLOP *** [9h 5s 3c]
MoKoZoBa: checks 
LtGrimms: bets 950
MoKoZoBa: calls 950
*** TURN *** [9h 5s 3c] [Qc]
MoKoZoBa: checks 
LtGrimms: bets 2000
MoKoZoBa: folds 
Uncalled bet (2000) returned to LtGrimms
LtGrimms collected 3720 from pot
*** SUMMARY ***
Total pot 3720 | Rake 0 
Board [9h 5s 3c Qc]
Seat 2: FIZZE76 (big blind) folded before Flop
Seat 3: DRAGOS FCSB folded before Flop (didn't bet)
Seat 4: R@nTAnpl@N folded before Flop (didn't bet)
Seat 5: Fakhish folded before Flop (didn't bet)
Seat 6: zas91 folded before Flop (didn't bet)
Seat 7: LtGrimms collected (3720)
Seat 8: Adios89 (button) folded before Flop (didn't bet)
Seat 9: MoKoZoBa (small blind) folded on the Turn



PokerStars Hand #139422913554: Tournament #1292680929, $10+$1 USD Hold'em No Limit - Level XII (150/300) - 2015/08/15 15:24:58 ET
Table '1292680929 17' 9-max Seat #9 is the button
Seat 2: FIZZE76 (5852 in chips) 
Seat 3: DRAGOS FCSB (13689 in chips) 
Seat 4: R@nTAnpl@N (12605 in chips) 
Seat 5: Fakhish (5550 in chips) 
Seat 6: zas91 (9404 in chips) 
Seat 7: LtGrimms (12838 in chips) 
Seat 8: Adios89 (6075 in chips) 
Seat 9: MoKoZoBa (4622 in chips) 
FIZZE76: posts the ante 40
DRAGOS FCSB: posts the ante 40
R@nTAnpl@N: posts the ante 40
Fakhish: posts the ante 40
zas91: posts the ante 40
LtGrimms: posts the ante 40
Adios89: posts the ante 40
MoKoZoBa: posts the ante 40
FIZZE76: posts small blind 150
DRAGOS FCSB: posts big blind 300
*** HOLE CARDS ***
Dealt to LtGrimms [Tc 6h]
R@nTAnpl@N: folds 
Fakhish: folds 
zas91: folds 
LtGrimms: folds 
Adios89: raises 300 to 600
MoKoZoBa: folds 
FIZZE76: folds 
DRAGOS FCSB: folds 
Uncalled bet (300) returned to Adios89
Adios89 collected 1070 from pot
*** SUMMARY ***
Total pot 1070 | Rake 0 
Seat 2: FIZZE76 (small blind) folded before Flop
Seat 3: DRAGOS FCSB (big blind) folded before Flop
Seat 4: R@nTAnpl@N folded before Flop (didn't bet)
Seat 5: Fakhish folded before Flop (didn't bet)
Seat 6: zas91 folded before Flop (didn't bet)
Seat 7: LtGrimms folded before Flop (didn't bet)
Seat 8: Adios89 collected (1070)
Seat 9: MoKoZoBa (button) folded before Flop (didn't bet)



PokerStars Hand #139422954571: Tournament #1292680929, $10+$1 USD Hold'em No Limit - Level XII (150/300) - 2015/08/15 15:25:50 ET
Table '1292680929 17' 9-max Seat #2 is the button
Seat 2: FIZZE76 (5662 in chips) 
Seat 3: DRAGOS FCSB (13349 in chips) 
Seat 4: R@nTAnpl@N (12565 in chips) 
Seat 5: Fakhish (5510 in chips) 
Seat 6: zas91 (9364 in chips) 
Seat 7: LtGrimms (12798 in chips) 
Seat 8: Adios89 (6805 in chips) 
Seat 9: MoKoZoBa (4582 in chips) 
FIZZE76: posts the ante 40
DRAGOS FCSB: posts the ante 40
R@nTAnpl@N: posts the ante 40
Fakhish: posts the ante 40
zas91: posts the ante 40
LtGrimms: posts the ante 40
Adios89: posts the ante 40
MoKoZoBa: posts the ante 40
DRAGOS FCSB: posts small blind 150
R@nTAnpl@N: posts big blind 300
*** HOLE CARDS ***
Dealt to LtGrimms [Qh 2s]
Fakhish: raises 300 to 600
zas91: folds 
LtGrimms: folds 
Adios89: folds 
MoKoZoBa: folds 
FIZZE76: folds 
DRAGOS FCSB: folds 
R@nTAnpl@N: folds 
Uncalled bet (300) returned to Fakhish
Fakhish collected 1070 from pot
*** SUMMARY ***
Total pot 1070 | Rake 0 
Seat 2: FIZZE76 (button) folded before Flop (didn't bet)
Seat 3: DRAGOS FCSB (small blind) folded before Flop
Seat 4: R@nTAnpl@N (big blind) folded before Flop
Seat 5: Fakhish collected (1070)
Seat 6: zas91 folded before Flop (didn't bet)
Seat 7: LtGrimms folded before Flop (didn't bet)
Seat 8: Adios89 folded before Flop (didn't bet)
Seat 9: MoKoZoBa folded before Flop (didn't bet)



PokerStars Hand #139422974258: Tournament #1292680929, $10+$1 USD Hold'em No Limit - Level XII (150/300) - 2015/08/15 15:26:16 ET
Table '1292680929 17' 9-max Seat #3 is the button
Seat 2: FIZZE76 (5622 in chips) 
Seat 3: DRAGOS FCSB (13159 in chips) 
Seat 4: R@nTAnpl@N (12225 in chips) 
Seat 5: Fakhish (6240 in chips) 
Seat 6: zas91 (9324 in chips) 
Seat 7: LtGrimms (12758 in chips) 
Seat 8: Adios89 (6765 in chips) 
Seat 9: MoKoZoBa (4542 in chips) 
FIZZE76: posts the ante 40
DRAGOS FCSB: posts the ante 40
R@nTAnpl@N: posts the ante 40
Fakhish: posts the ante 40
zas91: posts the ante 40
LtGrimms: posts the ante 40
Adios89: posts the ante 40
MoKoZoBa: posts the ante 40
R@nTAnpl@N: posts small blind 150
Fakhish: posts big blind 300
*** HOLE CARDS ***
Dealt to LtGrimms [3s 9c]
zas91: folds 
LtGrimms: folds 
Adios89: folds 
MoKoZoBa: folds 
FIZZE76: folds 
DRAGOS FCSB: folds 
R@nTAnpl@N: folds 
Uncalled bet (150) returned to Fakhish
Fakhish collected 620 from pot
*** SUMMARY ***
Total pot 620 | Rake 0 
Seat 2: FIZZE76 folded before Flop (didn't bet)
Seat 3: DRAGOS FCSB (button) folded before Flop (didn't bet)
Seat 4: R@nTAnpl@N (small blind) folded before Flop
Seat 5: Fakhish (big blind) collected (620)
Seat 6: zas91 folded before Flop (didn't bet)
Seat 7: LtGrimms folded before Flop (didn't bet)
Seat 8: Adios89 folded before Flop (didn't bet)
Seat 9: MoKoZoBa folded before Flop (didn't bet)



PokerStars Hand #139422992076: Tournament #1292680929, $10+$1 USD Hold'em No Limit - Level XII (150/300) - 2015/08/15 15:26:39 ET
Table '1292680929 17' 9-max Seat #4 is the button
Seat 1: hironisisaka (3364 in chips) 
Seat 2: FIZZE76 (5582 in chips) 
Seat 3: DRAGOS FCSB (13119 in chips) 
Seat 4: R@nTAnpl@N (12035 in chips) 
Seat 5: Fakhish (6670 in chips) 
Seat 6: zas91 (9284 in chips) 
Seat 7: LtGrimms (12718 in chips) 
Seat 8: Adios89 (6725 in chips) 
Seat 9: MoKoZoBa (4502 in chips) 
hironisisaka: posts the ante 40
FIZZE76: posts the ante 40
DRAGOS FCSB: posts the ante 40
R@nTAnpl@N: posts the ante 40
Fakhish: posts the ante 40
zas91: posts the ante 40
LtGrimms: posts the ante 40
Adios89: posts the ante 40
MoKoZoBa: posts the ante 40
Fakhish: posts small blind 150
zas91: posts big blind 300
*** HOLE CARDS ***
Dealt to LtGrimms [7h 4h]
LtGrimms: folds 
Adios89: folds 
MoKoZoBa: folds 
hironisisaka: folds 
FIZZE76: raises 441 to 741
DRAGOS FCSB: folds 
R@nTAnpl@N: folds 
Fakhish: folds 
zas91: folds 
Uncalled bet (441) returned to FIZZE76
FIZZE76 collected 1110 from pot
FIZZE76: doesn't show hand 
*** SUMMARY ***
Total pot 1110 | Rake 0 
Seat 1: hironisisaka folded before Flop (didn't bet)
Seat 2: FIZZE76 collected (1110)
Seat 3: DRAGOS FCSB folded before Flop (didn't bet)
Seat 4: R@nTAnpl@N (button) folded before Flop (didn't bet)
Seat 5: Fakhish (small blind) folded before Flop
Seat 6: zas91 (big blind) folded before Flop
Seat 7: LtGrimms folded before Flop (didn't bet)
Seat 8: Adios89 folded before Flop (didn't bet)
Seat 9: MoKoZoBa folded before Flop (didn't bet)



PokerStars Hand #139423021944: Tournament #1292680929, $10+$1 USD Hold'em No Limit - Level XII (150/300) - 2015/08/15 15:27:18 ET
Table '1292680929 17' 9-max Seat #5 is the button
Seat 1: hironisisaka (3324 in chips) 
Seat 2: FIZZE76 (6352 in chips) 
Seat 3: DRAGOS FCSB (13079 in chips) 
Seat 4: R@nTAnpl@N (11995 in chips) 
Seat 5: Fakhish (6480 in chips) 
Seat 6: zas91 (8944 in chips) 
Seat 7: LtGrimms (12678 in chips) 
Seat 8: Adios89 (6685 in chips) 
Seat 9: MoKoZoBa (4462 in chips) 
hironisisaka: posts the ante 40
FIZZE76: posts the ante 40
DRAGOS FCSB: posts the ante 40
R@nTAnpl@N: posts the ante 40
Fakhish: posts the ante 40
zas91: posts the ante 40
LtGrimms: posts the ante 40
Adios89: posts the ante 40
MoKoZoBa: posts the ante 40
zas91: posts small blind 150
LtGrimms: posts big blind 300
*** HOLE CARDS ***
Dealt to LtGrimms [Ac 3h]
Adios89: folds 
MoKoZoBa: folds 
hironisisaka: folds 
FIZZE76: folds 
DRAGOS FCSB: folds 
R@nTAnpl@N: folds 
Fakhish: folds 
zas91: raises 450 to 750
LtGrimms: calls 450
*** FLOP *** [7h Tc Qh]
zas91: bets 900
LtGrimms: folds 
Uncalled bet (900) returned to zas91
zas91 collected 1860 from pot
zas91: doesn't show hand 
*** SUMMARY ***
Total pot 1860 | Rake 0 
Board [7h Tc Qh]
Seat 1: hironisisaka folded before Flop (didn't bet)
Seat 2: FIZZE76 folded before Flop (didn't bet)
Seat 3: DRAGOS FCSB folded before Flop (didn't bet)
Seat 4: R@nTAnpl@N folded before Flop (didn't bet)
Seat 5: Fakhish (button) folded before Flop (didn't bet)
Seat 6: zas91 (small blind) collected (1860)
Seat 7: LtGrimms (big blind) folded on the Flop
Seat 8: Adios89 folded before Flop (didn't bet)
Seat 9: MoKoZoBa folded before Flop (didn't bet)



PokerStars Hand #139423071346: Tournament #1292680929, $10+$1 USD Hold'em No Limit - Level XII (150/300) - 2015/08/15 15:28:22 ET
Table '1292680929 17' 9-max Seat #6 is the button
Seat 1: hironisisaka (3284 in chips) 
Seat 2: FIZZE76 (6312 in chips) 
Seat 3: DRAGOS FCSB (13039 in chips) 
Seat 4: R@nTAnpl@N (11955 in chips) 
Seat 5: Fakhish (6440 in chips) 
Seat 6: zas91 (10014 in chips) 
Seat 7: LtGrimms (11888 in chips) 
Seat 8: Adios89 (6645 in chips) 
Seat 9: MoKoZoBa (4422 in chips) 
hironisisaka: posts the ante 40
FIZZE76: posts the ante 40
DRAGOS FCSB: posts the ante 40
R@nTAnpl@N: posts the ante 40
Fakhish: posts the ante 40
zas91: posts the ante 40
LtGrimms: posts the ante 40
Adios89: posts the ante 40
MoKoZoBa: posts the ante 40
LtGrimms: posts small blind 150
Adios89: posts big blind 300
*** HOLE CARDS ***
Dealt to LtGrimms [Ad Qc]
MoKoZoBa: folds 
hironisisaka: folds 
FIZZE76: folds 
DRAGOS FCSB: folds 
R@nTAnpl@N: folds 
Fakhish: raises 300 to 600
zas91: folds 
LtGrimms: raises 1400 to 2000
Adios89: folds 
Fakhish: folds 
Uncalled bet (1400) returned to LtGrimms
LtGrimms collected 1860 from pot
*** SUMMARY ***
Total pot 1860 | Rake 0 
Seat 1: hironisisaka folded before Flop (didn't bet)
Seat 2: FIZZE76 folded before Flop (didn't bet)
Seat 3: DRAGOS FCSB folded before Flop (didn't bet)
Seat 4: R@nTAnpl@N folded before Flop (didn't bet)
Seat 5: Fakhish folded before Flop
Seat 6: zas91 (button) folded before Flop (didn't bet)
Seat 7: LtGrimms (small blind) collected (1860)
Seat 8: Adios89 (big blind) folded before Flop
Seat 9: MoKoZoBa folded before Flop (didn't bet)



PokerStars Hand #139423108888: Tournament #1292680929, $10+$1 USD Hold'em No Limit - Level XIII (200/400) - 2015/08/15 15:29:10 ET
Table '1292680929 17' 9-max Seat #7 is the button
Seat 1: hironisisaka (3244 in chips) 
Seat 2: FIZZE76 (6272 in chips) 
Seat 3: DRAGOS FCSB (12999 in chips) 
Seat 4: R@nTAnpl@N (11915 in chips) 
Seat 5: Fakhish (5800 in chips) 
Seat 6: zas91 (9974 in chips) 
Seat 7: LtGrimms (13108 in chips) 
Seat 8: Adios89 (6305 in chips) 
Seat 9: MoKoZoBa (4382 in chips) 
hironisisaka: posts the ante 50
FIZZE76: posts the ante 50
DRAGOS FCSB: posts the ante 50
R@nTAnpl@N: posts the ante 50
Fakhish: posts the ante 50
zas91: posts the ante 50
LtGrimms: posts the ante 50
Adios89: posts the ante 50
MoKoZoBa: posts the ante 50
Adios89: posts small blind 200
MoKoZoBa: posts big blind 400
*** HOLE CARDS ***
Dealt to LtGrimms [7c 6d]
hironisisaka: folds 
FIZZE76: folds 
DRAGOS FCSB: folds 
R@nTAnpl@N: folds 
Fakhish: folds 
zas91: folds 
LtGrimms: folds 
Adios89: folds 
Uncalled bet (200) returned to MoKoZoBa
MoKoZoBa collected 850 from pot
*** SUMMARY ***
Total pot 850 | Rake 0 
Seat 1: hironisisaka folded before Flop (didn't bet)
Seat 2: FIZZE76 folded before Flop (didn't bet)
Seat 3: DRAGOS FCSB folded before Flop (didn't bet)
Seat 4: R@nTAnpl@N folded before Flop (didn't bet)
Seat 5: Fakhish folded before Flop (didn't bet)
Seat 6: zas91 folded before Flop (didn't bet)
Seat 7: LtGrimms (button) folded before Flop (didn't bet)
Seat 8: Adios89 (small blind) folded before Flop
Seat 9: MoKoZoBa (big blind) collected (850)



PokerStars Hand #139423128136: Tournament #1292680929, $10+$1 USD Hold'em No Limit - Level XIII (200/400) - 2015/08/15 15:29:36 ET
Table '1292680929 17' 9-max Seat #8 is the button
Seat 1: hironisisaka (3194 in chips) 
Seat 2: FIZZE76 (6222 in chips) 
Seat 3: DRAGOS FCSB (12949 in chips) 
Seat 4: R@nTAnpl@N (11865 in chips) 
Seat 5: Fakhish (5750 in chips) 
Seat 6: zas91 (9924 in chips) 
Seat 7: LtGrimms (13058 in chips) 
Seat 8: Adios89 (6055 in chips) 
Seat 9: MoKoZoBa (4982 in chips) 
hironisisaka: posts the ante 50
FIZZE76: posts the ante 50
DRAGOS FCSB: posts the ante 50
R@nTAnpl@N: posts the ante 50
Fakhish: posts the ante 50
zas91: posts the ante 50
LtGrimms: posts the ante 50
Adios89: posts the ante 50
MoKoZoBa: posts the ante 50
MoKoZoBa: posts small blind 200
hironisisaka: posts big blind 400
*** HOLE CARDS ***
Dealt to LtGrimms [Jh 9d]
FIZZE76: raises 551 to 951
DRAGOS FCSB: folds 
R@nTAnpl@N: folds 
Fakhish: folds 
zas91: folds 
LtGrimms: folds 
Adios89: folds 
MoKoZoBa: folds 
hironisisaka: folds 
Uncalled bet (551) returned to FIZZE76
FIZZE76 collected 1450 from pot
FIZZE76: doesn't show hand 
*** SUMMARY ***
Total pot 1450 | Rake 0 
Seat 1: hironisisaka (big blind) folded before Flop
Seat 2: FIZZE76 collected (1450)
Seat 3: DRAGOS FCSB folded before Flop (didn't bet)
Seat 4: R@nTAnpl@N folded before Flop (didn't bet)
Seat 5: Fakhish folded before Flop (didn't bet)
Seat 6: zas91 folded before Flop (didn't bet)
Seat 7: LtGrimms folded before Flop (didn't bet)
Seat 8: Adios89 (button) folded before Flop (didn't bet)
Seat 9: MoKoZoBa (small blind) folded before Flop



PokerStars Hand #139423154395: Tournament #1292680929, $10+$1 USD Hold'em No Limit - Level XIII (200/400) - 2015/08/15 15:30:10 ET
Table '1292680929 17' 9-max Seat #9 is the button
Seat 1: hironisisaka (2744 in chips) 
Seat 2: FIZZE76 (7222 in chips) 
Seat 3: DRAGOS FCSB (12899 in chips) 
Seat 4: R@nTAnpl@N (11815 in chips) 
Seat 5: Fakhish (5700 in chips) 
Seat 6: zas91 (9874 in chips) 
Seat 7: LtGrimms (13008 in chips) 
Seat 8: Adios89 (6005 in chips) 
Seat 9: MoKoZoBa (4732 in chips) 
hironisisaka: posts the ante 50
FIZZE76: posts the ante 50
DRAGOS FCSB: posts the ante 50
R@nTAnpl@N: posts the ante 50
Fakhish: posts the ante 50
zas91: posts the ante 50
LtGrimms: posts the ante 50
Adios89: posts the ante 50
MoKoZoBa: posts the ante 50
hironisisaka: posts small blind 200
FIZZE76: posts big blind 400
*** HOLE CARDS ***
Dealt to LtGrimms [Jh 5d]
DRAGOS FCSB: folds 
R@nTAnpl@N: folds 
Fakhish: folds 
zas91: folds 
LtGrimms: folds 
Adios89: folds 
MoKoZoBa: folds 
hironisisaka: raises 2294 to 2694 and is all-in
FIZZE76: folds 
Uncalled bet (2294) returned to hironisisaka
hironisisaka collected 1250 from pot
*** SUMMARY ***
Total pot 1250 | Rake 0 
Seat 1: hironisisaka (small blind) collected (1250)
Seat 2: FIZZE76 (big blind) folded before Flop
Seat 3: DRAGOS FCSB folded before Flop (didn't bet)
Seat 4: R@nTAnpl@N folded before Flop (didn't bet)
Seat 5: Fakhish folded before Flop (didn't bet)
Seat 6: zas91 folded before Flop (didn't bet)
Seat 7: LtGrimms folded before Flop (didn't bet)
Seat 8: Adios89 folded before Flop (didn't bet)
Seat 9: MoKoZoBa (button) folded before Flop (didn't bet)



PokerStars Hand #139423194960: Tournament #1292680929, $10+$1 USD Hold'em No Limit - Level XIII (200/400) - 2015/08/15 15:31:01 ET
Table '1292680929 17' 9-max Seat #1 is the button
Seat 1: hironisisaka (3544 in chips) 
Seat 2: FIZZE76 (6772 in chips) 
Seat 3: DRAGOS FCSB (12849 in chips) 
Seat 4: R@nTAnpl@N (11765 in chips) 
Seat 5: Fakhish (5650 in chips) 
Seat 6: zas91 (9824 in chips) 
Seat 7: LtGrimms (12958 in chips) 
Seat 8: Adios89 (5955 in chips) 
Seat 9: MoKoZoBa (4682 in chips) 
hironisisaka: posts the ante 50
FIZZE76: posts the ante 50
DRAGOS FCSB: posts the ante 50
R@nTAnpl@N: posts the ante 50
Fakhish: posts the ante 50
zas91: posts the ante 50
LtGrimms: posts the ante 50
Adios89: posts the ante 50
MoKoZoBa: posts the ante 50
FIZZE76: posts small blind 200
DRAGOS FCSB: posts big blind 400
*** HOLE CARDS ***
Dealt to LtGrimms [6c 4s]
R@nTAnpl@N: folds 
Fakhish: folds 
zas91: folds 
LtGrimms: folds 
Adios89: raises 5505 to 5905 and is all-in
MoKoZoBa: folds 
hironisisaka: folds 
FIZZE76: folds 
DRAGOS FCSB: folds 
Uncalled bet (5505) returned to Adios89
Adios89 collected 1450 from pot
*** SUMMARY ***
Total pot 1450 | Rake 0 
Seat 1: hironisisaka (button) folded before Flop (didn't bet)
Seat 2: FIZZE76 (small blind) folded before Flop
Seat 3: DRAGOS FCSB (big blind) folded before Flop
Seat 4: R@nTAnpl@N folded before Flop (didn't bet)
Seat 5: Fakhish folded before Flop (didn't bet)
Seat 6: zas91 folded before Flop (didn't bet)
Seat 7: LtGrimms folded before Flop (didn't bet)
Seat 8: Adios89 collected (1450)
Seat 9: MoKoZoBa folded before Flop (didn't bet)



PokerStars Hand #139423225950: Tournament #1292680929, $10+$1 USD Hold'em No Limit - Level XIII (200/400) - 2015/08/15 15:31:39 ET
Table '1292680929 17' 9-max Seat #2 is the button
Seat 1: hironisisaka (3494 in chips) 
Seat 2: FIZZE76 (6522 in chips) 
Seat 3: DRAGOS FCSB (12399 in chips) 
Seat 4: R@nTAnpl@N (11715 in chips) 
Seat 5: Fakhish (5600 in chips) 
Seat 6: zas91 (9774 in chips) 
Seat 7: LtGrimms (12908 in chips) 
Seat 8: Adios89 (6955 in chips) 
Seat 9: MoKoZoBa (4632 in chips) 
hironisisaka: posts the ante 50
FIZZE76: posts the ante 50
DRAGOS FCSB: posts the ante 50
R@nTAnpl@N: posts the ante 50
Fakhish: posts the ante 50
zas91: posts the ante 50
LtGrimms: posts the ante 50
Adios89: posts the ante 50
MoKoZoBa: posts the ante 50
DRAGOS FCSB: posts small blind 200
R@nTAnpl@N: posts big blind 400
*** HOLE CARDS ***
Dealt to LtGrimms [7s 9c]
Fakhish: folds 
zas91: raises 400 to 800
LtGrimms: folds 
Adios89: folds 
MoKoZoBa: raises 3782 to 4582 and is all-in
hironisisaka: folds 
FIZZE76: folds 
DRAGOS FCSB: folds 
R@nTAnpl@N: folds 
zas91: folds 
Uncalled bet (3782) returned to MoKoZoBa
MoKoZoBa collected 2650 from pot
*** SUMMARY ***
Total pot 2650 | Rake 0 
Seat 1: hironisisaka folded before Flop (didn't bet)
Seat 2: FIZZE76 (button) folded before Flop (didn't bet)
Seat 3: DRAGOS FCSB (small blind) folded before Flop
Seat 4: R@nTAnpl@N (big blind) folded before Flop
Seat 5: Fakhish folded before Flop (didn't bet)
Seat 6: zas91 folded before Flop
Seat 7: LtGrimms folded before Flop (didn't bet)
Seat 8: Adios89 folded before Flop (didn't bet)
Seat 9: MoKoZoBa collected (2650)



PokerStars Hand #139423260874: Tournament #1292680929, $10+$1 USD Hold'em No Limit - Level XIII (200/400) - 2015/08/15 15:32:22 ET
Table '1292680929 17' 9-max Seat #3 is the button
Seat 1: hironisisaka (3444 in chips) 
Seat 2: FIZZE76 (6472 in chips) 
Seat 3: DRAGOS FCSB (12149 in chips) 
Seat 4: R@nTAnpl@N (11265 in chips) 
Seat 5: Fakhish (5550 in chips) 
Seat 6: zas91 (8924 in chips) 
Seat 7: LtGrimms (12858 in chips) 
Seat 8: Adios89 (6905 in chips) 
Seat 9: MoKoZoBa (6432 in chips) 
hironisisaka: posts the ante 50
FIZZE76: posts the ante 50
DRAGOS FCSB: posts the ante 50
R@nTAnpl@N: posts the ante 50
Fakhish: posts the ante 50
zas91: posts the ante 50
LtGrimms: posts the ante 50
Adios89: posts the ante 50
MoKoZoBa: posts the ante 50
R@nTAnpl@N: posts small blind 200
Fakhish: posts big blind 400
*** HOLE CARDS ***
Dealt to LtGrimms [Qh 8h]
zas91: folds 
LtGrimms: folds 
Adios89: raises 400 to 800
MoKoZoBa: folds 
hironisisaka: folds 
FIZZE76: folds 
DRAGOS FCSB: folds 
R@nTAnpl@N: folds 
Fakhish: folds 
Uncalled bet (400) returned to Adios89
Adios89 collected 1450 from pot
*** SUMMARY ***
Total pot 1450 | Rake 0 
Seat 1: hironisisaka folded before Flop (didn't bet)
Seat 2: FIZZE76 folded before Flop (didn't bet)
Seat 3: DRAGOS FCSB (button) folded before Flop (didn't bet)
Seat 4: R@nTAnpl@N (small blind) folded before Flop
Seat 5: Fakhish (big blind) folded before Flop
Seat 6: zas91 folded before Flop (didn't bet)
Seat 7: LtGrimms folded before Flop (didn't bet)
Seat 8: Adios89 collected (1450)
Seat 9: MoKoZoBa folded before Flop (didn't bet)



PokerStars Hand #139423281043: Tournament #1292680929, $10+$1 USD Hold'em No Limit - Level XIII (200/400) - 2015/08/15 15:32:47 ET
Table '1292680929 17' 9-max Seat #4 is the button
Seat 1: hironisisaka (3394 in chips) 
Seat 2: FIZZE76 (6422 in chips) 
Seat 3: DRAGOS FCSB (12099 in chips) 
Seat 4: R@nTAnpl@N (11015 in chips) 
Seat 5: Fakhish (5100 in chips) 
Seat 6: zas91 (8874 in chips) 
Seat 7: LtGrimms (12808 in chips) 
Seat 8: Adios89 (7905 in chips) 
Seat 9: MoKoZoBa (6382 in chips) 
hironisisaka: posts the ante 50
FIZZE76: posts the ante 50
DRAGOS FCSB: posts the ante 50
R@nTAnpl@N: posts the ante 50
Fakhish: posts the ante 50
zas91: posts the ante 50
LtGrimms: posts the ante 50
Adios89: posts the ante 50
MoKoZoBa: posts the ante 50
Fakhish: posts small blind 200
zas91: posts big blind 400
*** HOLE CARDS ***
Dealt to LtGrimms [2c 8c]
LtGrimms: folds 
Adios89: folds 
MoKoZoBa: raises 400 to 800
hironisisaka: folds 
FIZZE76: folds 
DRAGOS FCSB: folds 
R@nTAnpl@N: folds 
Fakhish: folds 
zas91: raises 800 to 1600
MoKoZoBa: calls 800
*** FLOP *** [4d Qc Qd]
zas91: bets 1600
MoKoZoBa: folds 
Uncalled bet (1600) returned to zas91
zas91 collected 3850 from pot
zas91: doesn't show hand 
*** SUMMARY ***
Total pot 3850 | Rake 0 
Board [4d Qc Qd]
Seat 1: hironisisaka folded before Flop (didn't bet)
Seat 2: FIZZE76 folded before Flop (didn't bet)
Seat 3: DRAGOS FCSB folded before Flop (didn't bet)
Seat 4: R@nTAnpl@N (button) folded before Flop (didn't bet)
Seat 5: Fakhish (small blind) folded before Flop
Seat 6: zas91 (big blind) collected (3850)
Seat 7: LtGrimms folded before Flop (didn't bet)
Seat 8: Adios89 folded before Flop (didn't bet)
Seat 9: MoKoZoBa folded on the Flop



PokerStars Hand #139423328022: Tournament #1292680929, $10+$1 USD Hold'em No Limit - Level XIII (200/400) - 2015/08/15 15:33:44 ET
Table '1292680929 17' 9-max Seat #5 is the button
Seat 1: hironisisaka (3344 in chips) 
Seat 2: FIZZE76 (6372 in chips) 
Seat 3: DRAGOS FCSB (12049 in chips) 
Seat 4: R@nTAnpl@N (10965 in chips) 
Seat 5: Fakhish (4850 in chips) 
Seat 6: zas91 (11074 in chips) 
Seat 7: LtGrimms (12758 in chips) 
Seat 8: Adios89 (7855 in chips) 
Seat 9: MoKoZoBa (4732 in chips) 
hironisisaka: posts the ante 50
FIZZE76: posts the ante 50
DRAGOS FCSB: posts the ante 50
R@nTAnpl@N: posts the ante 50
Fakhish: posts the ante 50
zas91: posts the ante 50
LtGrimms: posts the ante 50
Adios89: posts the ante 50
MoKoZoBa: posts the ante 50
zas91: posts small blind 200
LtGrimms: posts big blind 400
*** HOLE CARDS ***
Dealt to LtGrimms [Qd Kd]
Adios89: folds 
MoKoZoBa: raises 400 to 800
hironisisaka: folds 
FIZZE76: folds 
DRAGOS FCSB: folds 
R@nTAnpl@N: folds 
Fakhish: folds 
zas91: folds 
LtGrimms: calls 400
*** FLOP *** [8c 7d Ah]
LtGrimms: checks 
MoKoZoBa: bets 1147
LtGrimms: folds 
Uncalled bet (1147) returned to MoKoZoBa
MoKoZoBa collected 2250 from pot
*** SUMMARY ***
Total pot 2250 | Rake 0 
Board [8c 7d Ah]
Seat 1: hironisisaka folded before Flop (didn't bet)
Seat 2: FIZZE76 folded before Flop (didn't bet)
Seat 3: DRAGOS FCSB folded before Flop (didn't bet)
Seat 4: R@nTAnpl@N folded before Flop (didn't bet)
Seat 5: Fakhish (button) folded before Flop (didn't bet)
Seat 6: zas91 (small blind) folded before Flop
Seat 7: LtGrimms (big blind) folded on the Flop
Seat 8: Adios89 folded before Flop (didn't bet)
Seat 9: MoKoZoBa collected (2250)



PokerStars Hand #139423375502: Tournament #1292680929, $10+$1 USD Hold'em No Limit - Level XIII (200/400) - 2015/08/15 15:34:43 ET
Table '1292680929 17' 9-max Seat #6 is the button
Seat 1: hironisisaka (3294 in chips) 
Seat 2: FIZZE76 (6322 in chips) 
Seat 3: DRAGOS FCSB (11999 in chips) 
Seat 4: R@nTAnpl@N (10915 in chips) 
Seat 5: Fakhish (4800 in chips) 
Seat 6: zas91 (10824 in chips) 
Seat 7: LtGrimms (11908 in chips) 
Seat 8: Adios89 (7805 in chips) 
Seat 9: MoKoZoBa (6132 in chips) 
hironisisaka: posts the ante 50
FIZZE76: posts the ante 50
DRAGOS FCSB: posts the ante 50
R@nTAnpl@N: posts the ante 50
Fakhish: posts the ante 50
zas91: posts the ante 50
LtGrimms: posts the ante 50
Adios89: posts the ante 50
MoKoZoBa: posts the ante 50
LtGrimms: posts small blind 200
Adios89: posts big blind 400
*** HOLE CARDS ***
Dealt to LtGrimms [5s Ah]
MoKoZoBa: folds 
hironisisaka: folds 
FIZZE76: folds 
DRAGOS FCSB: folds 
R@nTAnpl@N: folds 
Fakhish: folds 
zas91: folds 
LtGrimms: raises 400 to 800
Adios89: folds 
Uncalled bet (400) returned to LtGrimms
LtGrimms collected 1250 from pot
*** SUMMARY ***
Total pot 1250 | Rake 0 
Seat 1: hironisisaka folded before Flop (didn't bet)
Seat 2: FIZZE76 folded before Flop (didn't bet)
Seat 3: DRAGOS FCSB folded before Flop (didn't bet)
Seat 4: R@nTAnpl@N folded before Flop (didn't bet)
Seat 5: Fakhish folded before Flop (didn't bet)
Seat 6: zas91 (button) folded before Flop (didn't bet)
Seat 7: LtGrimms (small blind) collected (1250)
Seat 8: Adios89 (big blind) folded before Flop
Seat 9: MoKoZoBa folded before Flop (didn't bet)



PokerStars Hand #139423399761: Tournament #1292680929, $10+$1 USD Hold'em No Limit - Level XIII (200/400) - 2015/08/15 15:35:12 ET
Table '1292680929 17' 9-max Seat #7 is the button
Seat 1: hironisisaka (3244 in chips) 
Seat 2: FIZZE76 (6272 in chips) 
Seat 3: DRAGOS FCSB (11949 in chips) 
Seat 4: R@nTAnpl@N (10865 in chips) 
Seat 5: Fakhish (4750 in chips) 
Seat 6: zas91 (10774 in chips) 
Seat 7: LtGrimms (12708 in chips) 
Seat 8: Adios89 (7355 in chips) 
Seat 9: MoKoZoBa (6082 in chips) 
hironisisaka: posts the ante 50
FIZZE76: posts the ante 50
DRAGOS FCSB: posts the ante 50
R@nTAnpl@N: posts the ante 50
Fakhish: posts the ante 50
zas91: posts the ante 50
LtGrimms: posts the ante 50
Adios89: posts the ante 50
MoKoZoBa: posts the ante 50
Adios89: posts small blind 200
MoKoZoBa: posts big blind 400
*** HOLE CARDS ***
Dealt to LtGrimms [4c 9h]
hironisisaka: folds 
FIZZE76: folds 
DRAGOS FCSB: folds 
R@nTAnpl@N: folds 
Fakhish: folds 
zas91: folds 
LtGrimms: folds 
Adios89: folds 
Uncalled bet (200) returned to MoKoZoBa
MoKoZoBa collected 850 from pot
*** SUMMARY ***
Total pot 850 | Rake 0 
Seat 1: hironisisaka folded before Flop (didn't bet)
Seat 2: FIZZE76 folded before Flop (didn't bet)
Seat 3: DRAGOS FCSB folded before Flop (didn't bet)
Seat 4: R@nTAnpl@N folded before Flop (didn't bet)
Seat 5: Fakhish folded before Flop (didn't bet)
Seat 6: zas91 folded before Flop (didn't bet)
Seat 7: LtGrimms (button) folded before Flop (didn't bet)
Seat 8: Adios89 (small blind) folded before Flop
Seat 9: MoKoZoBa (big blind) collected (850)



PokerStars Hand #139423445270: Tournament #1292680929, $10+$1 USD Hold'em No Limit - Level XIII (200/400) - 2015/08/15 15:36:08 ET
Table '1292680929 17' 9-max Seat #8 is the button
Seat 1: hironisisaka (3194 in chips) 
Seat 2: FIZZE76 (6222 in chips) 
Seat 3: DRAGOS FCSB (11899 in chips) 
Seat 4: R@nTAnpl@N (10815 in chips) 
Seat 5: Fakhish (4700 in chips) 
Seat 6: zas91 (10724 in chips) 
Seat 7: LtGrimms (12658 in chips) 
Seat 8: Adios89 (7105 in chips) 
Seat 9: MoKoZoBa (6682 in chips) 
hironisisaka: posts the ante 50
FIZZE76: posts the ante 50
DRAGOS FCSB: posts the ante 50
R@nTAnpl@N: posts the ante 50
Fakhish: posts the ante 50
zas91: posts the ante 50
LtGrimms: posts the ante 50
Adios89: posts the ante 50
MoKoZoBa: posts the ante 50
MoKoZoBa: posts small blind 200
hironisisaka: posts big blind 400
*** HOLE CARDS ***
Dealt to LtGrimms [Jc 6c]
FIZZE76: folds 
DRAGOS FCSB: raises 400 to 800
R@nTAnpl@N: folds 
Fakhish: folds 
zas91: folds 
LtGrimms: folds 
Adios89: folds 
MoKoZoBa: folds 
hironisisaka: folds 
Uncalled bet (400) returned to DRAGOS FCSB
DRAGOS FCSB collected 1450 from pot
DRAGOS FCSB: doesn't show hand 
*** SUMMARY ***
Total pot 1450 | Rake 0 
Seat 1: hironisisaka (big blind) folded before Flop
Seat 2: FIZZE76 folded before Flop (didn't bet)
Seat 3: DRAGOS FCSB collected (1450)
Seat 4: R@nTAnpl@N folded before Flop (didn't bet)
Seat 5: Fakhish folded before Flop (didn't bet)
Seat 6: zas91 folded before Flop (didn't bet)
Seat 7: LtGrimms folded before Flop (didn't bet)
Seat 8: Adios89 (button) folded before Flop (didn't bet)
Seat 9: MoKoZoBa (small blind) folded before Flop



PokerStars Hand #139423474494: Tournament #1292680929, $10+$1 USD Hold'em No Limit - Level XIII (200/400) - 2015/08/15 15:36:44 ET
Table '1292680929 17' 9-max Seat #9 is the button
Seat 1: hironisisaka (2744 in chips) 
Seat 2: FIZZE76 (6172 in chips) 
Seat 3: DRAGOS FCSB (12899 in chips) 
Seat 4: R@nTAnpl@N (10765 in chips) 
Seat 5: Fakhish (4650 in chips) 
Seat 6: zas91 (10674 in chips) 
Seat 7: LtGrimms (12608 in chips) 
Seat 8: Adios89 (7055 in chips) 
Seat 9: MoKoZoBa (6432 in chips) 
hironisisaka: posts the ante 50
FIZZE76: posts the ante 50
DRAGOS FCSB: posts the ante 50
R@nTAnpl@N: posts the ante 50
Fakhish: posts the ante 50
zas91: posts the ante 50
LtGrimms: posts the ante 50
Adios89: posts the ante 50
MoKoZoBa: posts the ante 50
hironisisaka: posts small blind 200
FIZZE76: posts big blind 400
*** HOLE CARDS ***
Dealt to LtGrimms [Ts Jc]
DRAGOS FCSB: folds 
R@nTAnpl@N: folds 
Fakhish: raises 400 to 800
zas91: folds 
LtGrimms: folds 
Adios89: folds 
MoKoZoBa: folds 
hironisisaka: folds 
FIZZE76: folds 
Uncalled bet (400) returned to Fakhish
Fakhish collected 1450 from pot
*** SUMMARY ***
Total pot 1450 | Rake 0 
Seat 1: hironisisaka (small blind) folded before Flop
Seat 2: FIZZE76 (big blind) folded before Flop
Seat 3: DRAGOS FCSB folded before Flop (didn't bet)
Seat 4: R@nTAnpl@N folded before Flop (didn't bet)
Seat 5: Fakhish collected (1450)
Seat 6: zas91 folded before Flop (didn't bet)
Seat 7: LtGrimms folded before Flop (didn't bet)
Seat 8: Adios89 folded before Flop (didn't bet)
Seat 9: MoKoZoBa (button) folded before Flop (didn't bet)



PokerStars Hand #139423499130: Tournament #1292680929, $10+$1 USD Hold'em No Limit - Level XIII (200/400) - 2015/08/15 15:37:15 ET
Table '1292680929 17' 9-max Seat #1 is the button
Seat 1: hironisisaka (2494 in chips) 
Seat 2: FIZZE76 (5722 in chips) 
Seat 3: DRAGOS FCSB (12849 in chips) 
Seat 4: R@nTAnpl@N (10715 in chips) 
Seat 5: Fakhish (5650 in chips) 
Seat 6: zas91 (10624 in chips) 
Seat 7: LtGrimms (12558 in chips) 
Seat 8: Adios89 (7005 in chips) 
Seat 9: MoKoZoBa (6382 in chips) 
hironisisaka: posts the ante 50
FIZZE76: posts the ante 50
DRAGOS FCSB: posts the ante 50
R@nTAnpl@N: posts the ante 50
Fakhish: posts the ante 50
zas91: posts the ante 50
LtGrimms: posts the ante 50
Adios89: posts the ante 50
MoKoZoBa: posts the ante 50
FIZZE76: posts small blind 200
DRAGOS FCSB: posts big blind 400
*** HOLE CARDS ***
Dealt to LtGrimms [Jd 9c]
R@nTAnpl@N: folds 
Fakhish: folds 
zas91: folds 
LtGrimms: raises 400 to 800
Adios89: folds 
MoKoZoBa: folds 
hironisisaka: folds 
FIZZE76: folds 
DRAGOS FCSB: calls 400
*** FLOP *** [9h 8s 6h]
DRAGOS FCSB: checks 
LtGrimms: bets 1200
DRAGOS FCSB: raises 1600 to 2800
LtGrimms: calls 1600
*** TURN *** [9h 8s 6h] [3s]
DRAGOS FCSB: bets 3925
LtGrimms: folds 
Uncalled bet (3925) returned to DRAGOS FCSB
DRAGOS FCSB collected 7850 from pot
DRAGOS FCSB: doesn't show hand 
*** SUMMARY ***
Total pot 7850 | Rake 0 
Board [9h 8s 6h 3s]
Seat 1: hironisisaka (button) folded before Flop (didn't bet)
Seat 2: FIZZE76 (small blind) folded before Flop
Seat 3: DRAGOS FCSB (big blind) collected (7850)
Seat 4: R@nTAnpl@N folded before Flop (didn't bet)
Seat 5: Fakhish folded before Flop (didn't bet)
Seat 6: zas91 folded before Flop (didn't bet)
Seat 7: LtGrimms folded on the Turn
Seat 8: Adios89 folded before Flop (didn't bet)
Seat 9: MoKoZoBa folded before Flop (didn't bet)



PokerStars Hand #139423551127: Tournament #1292680929, $10+$1 USD Hold'em No Limit - Level XIII (200/400) - 2015/08/15 15:38:19 ET
Table '1292680929 17' 9-max Seat #2 is the button
Seat 1: hironisisaka (2444 in chips) 
Seat 2: FIZZE76 (5472 in chips) 
Seat 3: DRAGOS FCSB (17049 in chips) 
Seat 4: R@nTAnpl@N (10665 in chips) 
Seat 5: Fakhish (5600 in chips) 
Seat 6: zas91 (10574 in chips) 
Seat 7: LtGrimms (8908 in chips) 
Seat 8: Adios89 (6955 in chips) 
Seat 9: MoKoZoBa (6332 in chips) 
hironisisaka: posts the ante 50
FIZZE76: posts the ante 50
DRAGOS FCSB: posts the ante 50
R@nTAnpl@N: posts the ante 50
Fakhish: posts the ante 50
zas91: posts the ante 50
LtGrimms: posts the ante 50
Adios89: posts the ante 50
MoKoZoBa: posts the ante 50
DRAGOS FCSB: posts small blind 200
R@nTAnpl@N: posts big blind 400
*** HOLE CARDS ***
Dealt to LtGrimms [Qs Kh]
Fakhish: folds 
zas91: folds 
LtGrimms: raises 400 to 800
Adios89: folds 
MoKoZoBa: folds 
hironisisaka: folds 
FIZZE76: folds 
DRAGOS FCSB: folds 
R@nTAnpl@N: calls 400
*** FLOP *** [5c 4c 8s]
R@nTAnpl@N: checks 
LtGrimms: bets 1200
R@nTAnpl@N: calls 1200
*** TURN *** [5c 4c 8s] [Ts]
R@nTAnpl@N: checks 
LtGrimms: bets 2400
R@nTAnpl@N: folds 
Uncalled bet (2400) returned to LtGrimms
LtGrimms collected 4650 from pot
*** SUMMARY ***
Total pot 4650 | Rake 0 
Board [5c 4c 8s Ts]
Seat 1: hironisisaka folded before Flop (didn't bet)
Seat 2: FIZZE76 (button) folded before Flop (didn't bet)
Seat 3: DRAGOS FCSB (small blind) folded before Flop
Seat 4: R@nTAnpl@N (big blind) folded on the Turn
Seat 5: Fakhish folded before Flop (didn't bet)
Seat 6: zas91 folded before Flop (didn't bet)
Seat 7: LtGrimms collected (4650)
Seat 8: Adios89 folded before Flop (didn't bet)
Seat 9: MoKoZoBa folded before Flop (didn't bet)



PokerStars Hand #139423613015: Tournament #1292680929, $10+$1 USD Hold'em No Limit - Level XIV (250/500) - 2015/08/15 15:39:36 ET
Table '1292680929 17' 9-max Seat #3 is the button
Seat 1: hironisisaka (2394 in chips) 
Seat 2: FIZZE76 (5422 in chips) 
Seat 3: DRAGOS FCSB (16799 in chips) 
Seat 4: R@nTAnpl@N (8615 in chips) 
Seat 5: Fakhish (5550 in chips) 
Seat 6: zas91 (10524 in chips) 
Seat 7: LtGrimms (11508 in chips) 
Seat 8: Adios89 (6905 in chips) 
Seat 9: MoKoZoBa (6282 in chips) 
hironisisaka: posts the ante 60
FIZZE76: posts the ante 60
DRAGOS FCSB: posts the ante 60
R@nTAnpl@N: posts the ante 60
Fakhish: posts the ante 60
zas91: posts the ante 60
LtGrimms: posts the ante 60
Adios89: posts the ante 60
MoKoZoBa: posts the ante 60
R@nTAnpl@N: posts small blind 250
Fakhish: posts big blind 500
*** HOLE CARDS ***
Dealt to LtGrimms [Jc 9c]
zas91: folds 
LtGrimms: folds 
Adios89: folds 
MoKoZoBa: folds 
hironisisaka: raises 1834 to 2334 and is all-in
FIZZE76: folds 
DRAGOS FCSB: raises 14405 to 16739 and is all-in
R@nTAnpl@N: folds 
Fakhish: folds 
Uncalled bet (14405) returned to DRAGOS FCSB
*** FLOP *** [6c 3c 7s]
*** TURN *** [6c 3c 7s] [Ac]
*** RIVER *** [6c 3c 7s Ac] [Ah]
*** SHOW DOWN ***
hironisisaka: shows [Th As] (three of a kind, Aces)
DRAGOS FCSB: shows [Qh Kh] (a pair of Aces)
hironisisaka collected 5958 from pot
*** SUMMARY ***
Total pot 5958 | Rake 0 
Board [6c 3c 7s Ac Ah]
Seat 1: hironisisaka showed [Th As] and won (5958) with three of a kind, Aces
Seat 2: FIZZE76 folded before Flop (didn't bet)
Seat 3: DRAGOS FCSB (button) showed [Qh Kh] and lost with a pair of Aces
Seat 4: R@nTAnpl@N (small blind) folded before Flop
Seat 5: Fakhish (big blind) folded before Flop
Seat 6: zas91 folded before Flop (didn't bet)
Seat 7: LtGrimms folded before Flop (didn't bet)
Seat 8: Adios89 folded before Flop (didn't bet)
Seat 9: MoKoZoBa folded before Flop (didn't bet)



PokerStars Hand #139423661761: Tournament #1292680929, $10+$1 USD Hold'em No Limit - Level XIV (250/500) - 2015/08/15 15:40:36 ET
Table '1292680929 17' 9-max Seat #4 is the button
Seat 1: hironisisaka (5958 in chips) 
Seat 2: FIZZE76 (5362 in chips) 
Seat 3: DRAGOS FCSB (14405 in chips) 
Seat 4: R@nTAnpl@N (8305 in chips) 
Seat 5: Fakhish (4990 in chips) 
Seat 6: zas91 (10464 in chips) 
Seat 7: LtGrimms (11448 in chips) 
Seat 8: Adios89 (6845 in chips) 
Seat 9: MoKoZoBa (6222 in chips) 
hironisisaka: posts the ante 60
FIZZE76: posts the ante 60
DRAGOS FCSB: posts the ante 60
R@nTAnpl@N: posts the ante 60
Fakhish: posts the ante 60
zas91: posts the ante 60
LtGrimms: posts the ante 60
Adios89: posts the ante 60
MoKoZoBa: posts the ante 60
Fakhish: posts small blind 250
zas91: posts big blind 500
*** HOLE CARDS ***
Dealt to LtGrimms [5d 4s]
LtGrimms: folds 
Adios89: raises 6285 to 6785 and is all-in
MoKoZoBa: folds 
hironisisaka: folds 
FIZZE76: calls 5302 and is all-in
DRAGOS FCSB: folds 
R@nTAnpl@N: folds 
Fakhish: folds 
zas91: folds 
Uncalled bet (1483) returned to Adios89
*** FLOP *** [Tc 6c Ts]
*** TURN *** [Tc 6c Ts] [6d]
*** RIVER *** [Tc 6c Ts 6d] [3h]
*** SHOW DOWN ***
Adios89: shows [As Jc] (two pair, Tens and Sixes)
FIZZE76: shows [Ad Qc] (two pair, Tens and Sixes)
Adios89 collected 5947 from pot
FIZZE76 collected 5947 from pot
*** SUMMARY ***
Total pot 11894 | Rake 0 
Board [Tc 6c Ts 6d 3h]
Seat 1: hironisisaka folded before Flop (didn't bet)
Seat 2: FIZZE76 showed [Ad Qc] and won (5947) with two pair, Tens and Sixes
Seat 3: DRAGOS FCSB folded before Flop (didn't bet)
Seat 4: R@nTAnpl@N (button) folded before Flop (didn't bet)
Seat 5: Fakhish (small blind) folded before Flop
Seat 6: zas91 (big blind) folded before Flop
Seat 7: LtGrimms folded before Flop (didn't bet)
Seat 8: Adios89 showed [As Jc] and won (5947) with two pair, Tens and Sixes
Seat 9: MoKoZoBa folded before Flop (didn't bet)



PokerStars Hand #139423687535: Tournament #1292680929, $10+$1 USD Hold'em No Limit - Level XIV (250/500) - 2015/08/15 15:41:09 ET
Table '1292680929 17' 9-max Seat #5 is the button
Seat 1: hironisisaka (5898 in chips) 
Seat 2: FIZZE76 (5947 in chips) 
Seat 3: DRAGOS FCSB (14345 in chips) 
Seat 4: R@nTAnpl@N (8245 in chips) 
Seat 5: Fakhish (4680 in chips) 
Seat 6: zas91 (9904 in chips) 
Seat 7: LtGrimms (11388 in chips) 
Seat 8: Adios89 (7430 in chips) 
Seat 9: MoKoZoBa (6162 in chips) 
hironisisaka: posts the ante 60
FIZZE76: posts the ante 60
DRAGOS FCSB: posts the ante 60
R@nTAnpl@N: posts the ante 60
Fakhish: posts the ante 60
zas91: posts the ante 60
LtGrimms: posts the ante 60
Adios89: posts the ante 60
MoKoZoBa: posts the ante 60
zas91: posts small blind 250
LtGrimms: posts big blind 500
*** HOLE CARDS ***
Dealt to LtGrimms [2s Td]
Adios89: folds 
MoKoZoBa: folds 
hironisisaka: folds 
FIZZE76: folds 
DRAGOS FCSB: raises 500 to 1000
R@nTAnpl@N: folds 
Fakhish: raises 3620 to 4620 and is all-in
zas91: folds 
LtGrimms: folds 
DRAGOS FCSB: calls 3620
*** FLOP *** [3d 2h 7h]
*** TURN *** [3d 2h 7h] [Qh]
*** RIVER *** [3d 2h 7h Qh] [As]
*** SHOW DOWN ***
DRAGOS FCSB: shows [Tc Ks] (high card Ace)
Fakhish: shows [7s 6s] (a pair of Sevens)
Fakhish collected 10530 from pot
*** SUMMARY ***
Total pot 10530 | Rake 0 
Board [3d 2h 7h Qh As]
Seat 1: hironisisaka folded before Flop (didn't bet)
Seat 2: FIZZE76 folded before Flop (didn't bet)
Seat 3: DRAGOS FCSB showed [Tc Ks] and lost with high card Ace
Seat 4: R@nTAnpl@N folded before Flop (didn't bet)
Seat 5: Fakhish (button) showed [7s 6s] and won (10530) with a pair of Sevens
Seat 6: zas91 (small blind) folded before Flop
Seat 7: LtGrimms (big blind) folded before Flop
Seat 8: Adios89 folded before Flop (didn't bet)
Seat 9: MoKoZoBa folded before Flop (didn't bet)



PokerStars Hand #139423730137: Tournament #1292680929, $10+$1 USD Hold'em No Limit - Level XIV (250/500) - 2015/08/15 15:42:02 ET
Table '1292680929 17' 9-max Seat #6 is the button
Seat 1: hironisisaka (5838 in chips) 
Seat 2: FIZZE76 (5887 in chips) 
Seat 3: DRAGOS FCSB (9665 in chips) 
Seat 4: R@nTAnpl@N (8185 in chips) 
Seat 5: Fakhish (10530 in chips) 
Seat 6: zas91 (9594 in chips) 
Seat 7: LtGrimms (10828 in chips) 
Seat 8: Adios89 (7370 in chips) 
Seat 9: MoKoZoBa (6102 in chips) 
hironisisaka: posts the ante 60
FIZZE76: posts the ante 60
DRAGOS FCSB: posts the ante 60
R@nTAnpl@N: posts the ante 60
Fakhish: posts the ante 60
zas91: posts the ante 60
LtGrimms: posts the ante 60
Adios89: posts the ante 60
MoKoZoBa: posts the ante 60
LtGrimms: posts small blind 250
Adios89: posts big blind 500
*** HOLE CARDS ***
Dealt to LtGrimms [4d As]
MoKoZoBa: folds 
hironisisaka: folds 
FIZZE76: folds 
DRAGOS FCSB: folds 
R@nTAnpl@N: folds 
Fakhish: folds 
zas91: folds 
LtGrimms: folds 
Uncalled bet (250) returned to Adios89
Adios89 collected 1040 from pot
*** SUMMARY ***
Total pot 1040 | Rake 0 
Seat 1: hironisisaka folded before Flop (didn't bet)
Seat 2: FIZZE76 folded before Flop (didn't bet)
Seat 3: DRAGOS FCSB folded before Flop (didn't bet)
Seat 4: R@nTAnpl@N folded before Flop (didn't bet)
Seat 5: Fakhish folded before Flop (didn't bet)
Seat 6: zas91 (button) folded before Flop (didn't bet)
Seat 7: LtGrimms (small blind) folded before Flop
Seat 8: Adios89 (big blind) collected (1040)
Seat 9: MoKoZoBa folded before Flop (didn't bet)



PokerStars Hand #139423751570: Tournament #1292680929, $10+$1 USD Hold'em No Limit - Level XIV (250/500) - 2015/08/15 15:42:27 ET
Table '1292680929 17' 9-max Seat #7 is the button
Seat 1: hironisisaka (5778 in chips) 
Seat 2: FIZZE76 (5827 in chips) 
Seat 3: DRAGOS FCSB (9605 in chips) 
Seat 4: R@nTAnpl@N (8125 in chips) 
Seat 5: Fakhish (10470 in chips) 
Seat 6: zas91 (9534 in chips) 
Seat 7: LtGrimms (10518 in chips) 
Seat 8: Adios89 (8100 in chips) 
Seat 9: MoKoZoBa (6042 in chips) 
hironisisaka: posts the ante 60
FIZZE76: posts the ante 60
DRAGOS FCSB: posts the ante 60
R@nTAnpl@N: posts the ante 60
Fakhish: posts the ante 60
zas91: posts the ante 60
LtGrimms: posts the ante 60
Adios89: posts the ante 60
MoKoZoBa: posts the ante 60
Adios89: posts small blind 250
MoKoZoBa: posts big blind 500
*** HOLE CARDS ***
Dealt to LtGrimms [Kh As]
hironisisaka: folds 
FIZZE76: folds 
DRAGOS FCSB: folds 
R@nTAnpl@N: raises 500 to 1000
Fakhish: folds 
zas91: folds 
LtGrimms: raises 2000 to 3000
Adios89: folds 
MoKoZoBa: folds 
R@nTAnpl@N: folds 
Uncalled bet (2000) returned to LtGrimms
LtGrimms collected 3290 from pot
*** SUMMARY ***
Total pot 3290 | Rake 0 
Seat 1: hironisisaka folded before Flop (didn't bet)
Seat 2: FIZZE76 folded before Flop (didn't bet)
Seat 3: DRAGOS FCSB folded before Flop (didn't bet)
Seat 4: R@nTAnpl@N folded before Flop
Seat 5: Fakhish folded before Flop (didn't bet)
Seat 6: zas91 folded before Flop (didn't bet)
Seat 7: LtGrimms (button) collected (3290)
Seat 8: Adios89 (small blind) folded before Flop
Seat 9: MoKoZoBa (big blind) folded before Flop



PokerStars Hand #139423787545: Tournament #1292680929, $10+$1 USD Hold'em No Limit - Level XIV (250/500) - 2015/08/15 15:43:12 ET
Table '1292680929 17' 9-max Seat #8 is the button
Seat 1: hironisisaka (5718 in chips) 
Seat 2: FIZZE76 (5767 in chips) 
Seat 3: DRAGOS FCSB (9545 in chips) 
Seat 4: R@nTAnpl@N (7065 in chips) 
Seat 5: Fakhish (10410 in chips) 
Seat 6: zas91 (9474 in chips) 
Seat 7: LtGrimms (12748 in chips) 
Seat 8: Adios89 (7790 in chips) 
Seat 9: MoKoZoBa (5482 in chips) 
hironisisaka: posts the ante 60
FIZZE76: posts the ante 60
DRAGOS FCSB: posts the ante 60
R@nTAnpl@N: posts the ante 60
Fakhish: posts the ante 60
zas91: posts the ante 60
LtGrimms: posts the ante 60
Adios89: posts the ante 60
MoKoZoBa: posts the ante 60
MoKoZoBa: posts small blind 250
hironisisaka: posts big blind 500
*** HOLE CARDS ***
Dealt to LtGrimms [2d Jc]
FIZZE76: folds 
DRAGOS FCSB: folds 
R@nTAnpl@N: folds 
Fakhish: folds 
zas91: folds 
LtGrimms: folds 
Adios89: raises 7230 to 7730 and is all-in
MoKoZoBa: calls 5172 and is all-in
hironisisaka: folds 
Uncalled bet (2308) returned to Adios89
*** FLOP *** [Qc 9c 3c]
*** TURN *** [Qc 9c 3c] [5d]
*** RIVER *** [Qc 9c 3c 5d] [Ah]
*** SHOW DOWN ***
MoKoZoBa: shows [Ac Ks] (a pair of Aces)
Adios89: shows [Jd Qh] (a pair of Queens)
MoKoZoBa collected 11884 from pot
*** SUMMARY ***
Total pot 11884 | Rake 0 
Board [Qc 9c 3c 5d Ah]
Seat 1: hironisisaka (big blind) folded before Flop
Seat 2: FIZZE76 folded before Flop (didn't bet)
Seat 3: DRAGOS FCSB folded before Flop (didn't bet)
Seat 4: R@nTAnpl@N folded before Flop (didn't bet)
Seat 5: Fakhish folded before Flop (didn't bet)
Seat 6: zas91 folded before Flop (didn't bet)
Seat 7: LtGrimms folded before Flop (didn't bet)
Seat 8: Adios89 (button) showed [Jd Qh] and lost with a pair of Queens
Seat 9: MoKoZoBa (small blind) showed [Ac Ks] and won (11884) with a pair of Aces



PokerStars Hand #139423816043: Tournament #1292680929, $10+$1 USD Hold'em No Limit - Level XIV (250/500) - 2015/08/15 15:43:47 ET
Table '1292680929 17' 9-max Seat #9 is the button
Seat 1: hironisisaka (5158 in chips) 
Seat 2: FIZZE76 (5707 in chips) 
Seat 3: DRAGOS FCSB (9485 in chips) 
Seat 4: R@nTAnpl@N (7005 in chips) 
Seat 5: Fakhish (10350 in chips) 
Seat 6: zas91 (9414 in chips) 
Seat 7: LtGrimms (12688 in chips) 
Seat 8: Adios89 (2308 in chips) 
Seat 9: MoKoZoBa (11884 in chips) 
hironisisaka: posts the ante 60
FIZZE76: posts the ante 60
DRAGOS FCSB: posts the ante 60
R@nTAnpl@N: posts the ante 60
Fakhish: posts the ante 60
zas91: posts the ante 60
LtGrimms: posts the ante 60
Adios89: posts the ante 60
MoKoZoBa: posts the ante 60
hironisisaka: posts small blind 250
FIZZE76: posts big blind 500
*** HOLE CARDS ***
Dealt to LtGrimms [2s 2c]
DRAGOS FCSB: folds 
R@nTAnpl@N: folds 
Fakhish: folds 
zas91: folds 
LtGrimms: raises 500 to 1000
Adios89: folds 
MoKoZoBa: folds 
hironisisaka: folds 
FIZZE76: raises 4647 to 5647 and is all-in
LtGrimms: calls 4647
*** FLOP *** [Qc 8h 6s]
*** TURN *** [Qc 8h 6s] [Ad]
*** RIVER *** [Qc 8h 6s Ad] [7s]
*** SHOW DOWN ***
FIZZE76: shows [Ac 4h] (a pair of Aces)
LtGrimms: shows [2s 2c] (a pair of Deuces)
FIZZE76 collected 12084 from pot
*** SUMMARY ***
Total pot 12084 | Rake 0 
Board [Qc 8h 6s Ad 7s]
Seat 1: hironisisaka (small blind) folded before Flop
Seat 2: FIZZE76 (big blind) showed [Ac 4h] and won (12084) with a pair of Aces
Seat 3: DRAGOS FCSB folded before Flop (didn't bet)
Seat 4: R@nTAnpl@N folded before Flop (didn't bet)
Seat 5: Fakhish folded before Flop (didn't bet)
Seat 6: zas91 folded before Flop (didn't bet)
Seat 7: LtGrimms showed [2s 2c] and lost with a pair of Deuces
Seat 8: Adios89 folded before Flop (didn't bet)
Seat 9: MoKoZoBa (button) folded before Flop (didn't bet)



PokerStars Hand #139423847037: Tournament #1292680929, $10+$1 USD Hold'em No Limit - Level XIV (250/500) - 2015/08/15 15:44:25 ET
Table '1292680929 17' 9-max Seat #1 is the button
Seat 1: hironisisaka (4848 in chips) 
Seat 2: FIZZE76 (12084 in chips) 
Seat 3: DRAGOS FCSB (9425 in chips) 
Seat 4: R@nTAnpl@N (6945 in chips) 
Seat 5: Fakhish (10290 in chips) 
Seat 6: zas91 (9354 in chips) 
Seat 7: LtGrimms (6981 in chips) 
Seat 8: Adios89 (2248 in chips) 
Seat 9: MoKoZoBa (11824 in chips) 
hironisisaka: posts the ante 60
FIZZE76: posts the ante 60
DRAGOS FCSB: posts the ante 60
R@nTAnpl@N: posts the ante 60
Fakhish: posts the ante 60
zas91: posts the ante 60
LtGrimms: posts the ante 60
Adios89: posts the ante 60
MoKoZoBa: posts the ante 60
FIZZE76: posts small blind 250
DRAGOS FCSB: posts big blind 500
*** HOLE CARDS ***
Dealt to LtGrimms [8s Qs]
R@nTAnpl@N: folds 
Fakhish: folds 
zas91: folds 
LtGrimms: folds 
Adios89: folds 
MoKoZoBa: folds 
hironisisaka: raises 4288 to 4788 and is all-in
FIZZE76: folds 
DRAGOS FCSB: folds 
Uncalled bet (4288) returned to hironisisaka
hironisisaka collected 1790 from pot
*** SUMMARY ***
Total pot 1790 | Rake 0 
Seat 1: hironisisaka (button) collected (1790)
Seat 2: FIZZE76 (small blind) folded before Flop
Seat 3: DRAGOS FCSB (big blind) folded before Flop
Seat 4: R@nTAnpl@N folded before Flop (didn't bet)
Seat 5: Fakhish folded before Flop (didn't bet)
Seat 6: zas91 folded before Flop (didn't bet)
Seat 7: LtGrimms folded before Flop (didn't bet)
Seat 8: Adios89 folded before Flop (didn't bet)
Seat 9: MoKoZoBa folded before Flop (didn't bet)



PokerStars Hand #139423888314: Tournament #1292680929, $10+$1 USD Hold'em No Limit - Level XIV (250/500) - 2015/08/15 15:45:15 ET
Table '1292680929 17' 9-max Seat #2 is the button
Seat 1: hironisisaka (6078 in chips) 
Seat 2: FIZZE76 (11774 in chips) 
Seat 3: DRAGOS FCSB (8865 in chips) 
Seat 4: R@nTAnpl@N (6885 in chips) 
Seat 5: Fakhish (10230 in chips) 
Seat 6: zas91 (9294 in chips) 
Seat 7: LtGrimms (6921 in chips) 
Seat 8: Adios89 (2188 in chips) 
Seat 9: MoKoZoBa (11764 in chips) 
hironisisaka: posts the ante 60
FIZZE76: posts the ante 60
DRAGOS FCSB: posts the ante 60
R@nTAnpl@N: posts the ante 60
Fakhish: posts the ante 60
zas91: posts the ante 60
LtGrimms: posts the ante 60
Adios89: posts the ante 60
MoKoZoBa: posts the ante 60
DRAGOS FCSB: posts small blind 250
R@nTAnpl@N: posts big blind 500
*** HOLE CARDS ***
Dealt to LtGrimms [4s Jc]
Fakhish: folds 
zas91: raises 500 to 1000
LtGrimms: folds 
Adios89: folds 
MoKoZoBa: folds 
hironisisaka: folds 
FIZZE76: folds 
DRAGOS FCSB: folds 
R@nTAnpl@N: calls 500
*** FLOP *** [8c 4h 5c]
R@nTAnpl@N: checks 
zas91: bets 1450
R@nTAnpl@N: folds 
Uncalled bet (1450) returned to zas91
zas91 collected 2790 from pot
zas91: doesn't show hand 
*** SUMMARY ***
Total pot 2790 | Rake 0 
Board [8c 4h 5c]
Seat 1: hironisisaka folded before Flop (didn't bet)
Seat 2: FIZZE76 (button) folded before Flop (didn't bet)
Seat 3: DRAGOS FCSB (small blind) folded before Flop
Seat 4: R@nTAnpl@N (big blind) folded on the Flop
Seat 5: Fakhish folded before Flop (didn't bet)
Seat 6: zas91 collected (2790)
Seat 7: LtGrimms folded before Flop (didn't bet)
Seat 8: Adios89 folded before Flop (didn't bet)
Seat 9: MoKoZoBa folded before Flop (didn't bet)



PokerStars Hand #139423949443: Tournament #1292680929, $10+$1 USD Hold'em No Limit - Level XIV (250/500) - 2015/08/15 15:46:30 ET
Table '1292680929 17' 9-max Seat #3 is the button
Seat 1: hironisisaka (6018 in chips) 
Seat 2: FIZZE76 (11714 in chips) 
Seat 3: DRAGOS FCSB (8555 in chips) 
Seat 4: R@nTAnpl@N (5825 in chips) 
Seat 5: Fakhish (10170 in chips) 
Seat 6: zas91 (11024 in chips) 
Seat 7: LtGrimms (6861 in chips) 
Seat 8: Adios89 (2128 in chips) 
Seat 9: MoKoZoBa (11704 in chips) 
hironisisaka: posts the ante 60
FIZZE76: posts the ante 60
DRAGOS FCSB: posts the ante 60
R@nTAnpl@N: posts the ante 60
Fakhish: posts the ante 60
zas91: posts the ante 60
LtGrimms: posts the ante 60
Adios89: posts the ante 60
MoKoZoBa: posts the ante 60
R@nTAnpl@N: posts small blind 250
Fakhish: posts big blind 500
*** HOLE CARDS ***
Dealt to LtGrimms [6h Qs]
zas91: folds 
LtGrimms: folds 
Adios89: raises 1568 to 2068 and is all-in
MoKoZoBa: folds 
hironisisaka: folds 
FIZZE76: folds 
DRAGOS FCSB: raises 6427 to 8495 and is all-in
R@nTAnpl@N: folds 
Fakhish: folds 
Uncalled bet (6427) returned to DRAGOS FCSB
*** FLOP *** [3d Kc 4s]
*** TURN *** [3d Kc 4s] [9d]
*** RIVER *** [3d Kc 4s 9d] [6c]
*** SHOW DOWN ***
Adios89: shows [8h Ks] (a pair of Kings)
DRAGOS FCSB: shows [Td Th] (a pair of Tens)
Adios89 collected 5426 from pot
*** SUMMARY ***
Total pot 5426 | Rake 0 
Board [3d Kc 4s 9d 6c]
Seat 1: hironisisaka folded before Flop (didn't bet)
Seat 2: FIZZE76 folded before Flop (didn't bet)
Seat 3: DRAGOS FCSB (button) showed [Td Th] and lost with a pair of Tens
Seat 4: R@nTAnpl@N (small blind) folded before Flop
Seat 5: Fakhish (big blind) folded before Flop
Seat 6: zas91 folded before Flop (didn't bet)
Seat 7: LtGrimms folded before Flop (didn't bet)
Seat 8: Adios89 showed [8h Ks] and won (5426) with a pair of Kings
Seat 9: MoKoZoBa folded before Flop (didn't bet)



PokerStars Hand #139423995596: Tournament #1292680929, $10+$1 USD Hold'em No Limit - Level XIV (250/500) - 2015/08/15 15:47:26 ET
Table '1292680929 17' 9-max Seat #4 is the button
Seat 1: hironisisaka (5958 in chips) 
Seat 2: FIZZE76 (11654 in chips) 
Seat 3: DRAGOS FCSB (6427 in chips) 
Seat 4: R@nTAnpl@N (5515 in chips) 
Seat 5: Fakhish (9610 in chips) 
Seat 6: zas91 (10964 in chips) 
Seat 7: LtGrimms (6801 in chips) 
Seat 8: Adios89 (5426 in chips) 
Seat 9: MoKoZoBa (11644 in chips) 
hironisisaka: posts the ante 60
FIZZE76: posts the ante 60
DRAGOS FCSB: posts the ante 60
R@nTAnpl@N: posts the ante 60
Fakhish: posts the ante 60
zas91: posts the ante 60
LtGrimms: posts the ante 60
Adios89: posts the ante 60
MoKoZoBa: posts the ante 60
Fakhish: posts small blind 250
zas91: posts big blind 500
*** HOLE CARDS ***
Dealt to LtGrimms [Ks 6h]
LtGrimms: folds 
Adios89: folds 
MoKoZoBa: raises 500 to 1000
hironisisaka: calls 1000
FIZZE76: folds 
DRAGOS FCSB: folds 
R@nTAnpl@N: folds 
Fakhish: folds 
zas91: folds 
*** FLOP *** [9c 7s 5c]
MoKoZoBa: bets 1677
hironisisaka: raises 3221 to 4898 and is all-in
MoKoZoBa: calls 3221
*** TURN *** [9c 7s 5c] [Jc]
*** RIVER *** [9c 7s 5c Jc] [6c]
*** SHOW DOWN ***
MoKoZoBa: shows [Td 9d] (a pair of Nines)
hironisisaka: shows [As Ad] (a pair of Aces)
hironisisaka collected 13086 from pot
*** SUMMARY ***
Total pot 13086 | Rake 0 
Board [9c 7s 5c Jc 6c]
Seat 1: hironisisaka showed [As Ad] and won (13086) with a pair of Aces
Seat 2: FIZZE76 folded before Flop (didn't bet)
Seat 3: DRAGOS FCSB folded before Flop (didn't bet)
Seat 4: R@nTAnpl@N (button) folded before Flop (didn't bet)
Seat 5: Fakhish (small blind) folded before Flop
Seat 6: zas91 (big blind) folded before Flop
Seat 7: LtGrimms folded before Flop (didn't bet)
Seat 8: Adios89 folded before Flop (didn't bet)
Seat 9: MoKoZoBa showed [Td 9d] and lost with a pair of Nines



PokerStars Hand #139424042420: Tournament #1292680929, $10+$1 USD Hold'em No Limit - Level XIV (250/500) - 2015/08/15 15:48:24 ET
Table '1292680929 17' 9-max Seat #5 is the button
Seat 1: hironisisaka (13086 in chips) 
Seat 2: FIZZE76 (11594 in chips) 
Seat 3: DRAGOS FCSB (6367 in chips) 
Seat 4: R@nTAnpl@N (5455 in chips) 
Seat 5: Fakhish (9300 in chips) 
Seat 6: zas91 (10404 in chips) 
Seat 7: LtGrimms (6741 in chips) 
Seat 8: Adios89 (5366 in chips) 
Seat 9: MoKoZoBa (5686 in chips) 
hironisisaka: posts the ante 60
FIZZE76: posts the ante 60
DRAGOS FCSB: posts the ante 60
R@nTAnpl@N: posts the ante 60
Fakhish: posts the ante 60
zas91: posts the ante 60
LtGrimms: posts the ante 60
Adios89: posts the ante 60
MoKoZoBa: posts the ante 60
zas91: posts small blind 250
LtGrimms: posts big blind 500
*** HOLE CARDS ***
Dealt to LtGrimms [9h As]
Adios89: folds 
MoKoZoBa: folds 
hironisisaka: folds 
FIZZE76: folds 
DRAGOS FCSB: folds 
R@nTAnpl@N: folds 
Fakhish: raises 500 to 1000
zas91: folds 
LtGrimms: raises 2790 to 3790
Fakhish: folds 
Uncalled bet (2790) returned to LtGrimms
LtGrimms collected 2790 from pot
*** SUMMARY ***
Total pot 2790 | Rake 0 
Seat 1: hironisisaka folded before Flop (didn't bet)
Seat 2: FIZZE76 folded before Flop (didn't bet)
Seat 3: DRAGOS FCSB folded before Flop (didn't bet)
Seat 4: R@nTAnpl@N folded before Flop (didn't bet)
Seat 5: Fakhish (button) folded before Flop
Seat 6: zas91 (small blind) folded before Flop
Seat 7: LtGrimms (big blind) collected (2790)
Seat 8: Adios89 folded before Flop (didn't bet)
Seat 9: MoKoZoBa folded before Flop (didn't bet)



PokerStars Hand #139424084194: Tournament #1292680929, $10+$1 USD Hold'em No Limit - Level XV (300/600) - 2015/08/15 15:49:15 ET
Table '1292680929 17' 9-max Seat #6 is the button
Seat 1: hironisisaka (13026 in chips) 
Seat 2: FIZZE76 (11534 in chips) 
Seat 3: DRAGOS FCSB (6307 in chips) 
Seat 4: R@nTAnpl@N (5395 in chips) 
Seat 5: Fakhish (8240 in chips) 
Seat 6: zas91 (10094 in chips) 
Seat 7: LtGrimms (8471 in chips) 
Seat 8: Adios89 (5306 in chips) 
Seat 9: MoKoZoBa (5626 in chips) 
hironisisaka: posts the ante 70
FIZZE76: posts the ante 70
DRAGOS FCSB: posts the ante 70
R@nTAnpl@N: posts the ante 70
Fakhish: posts the ante 70
zas91: posts the ante 70
LtGrimms: posts the ante 70
Adios89: posts the ante 70
MoKoZoBa: posts the ante 70
LtGrimms: posts small blind 300
Adios89: posts big blind 600
*** HOLE CARDS ***
Dealt to LtGrimms [Qh Jd]
MoKoZoBa: folds 
hironisisaka: folds 
FIZZE76: folds 
DRAGOS FCSB: folds 
R@nTAnpl@N: raises 4725 to 5325 and is all-in
Fakhish: folds 
zas91: folds 
LtGrimms: folds 
Adios89: calls 4636 and is all-in
Uncalled bet (89) returned to R@nTAnpl@N
*** FLOP *** [Qs As 2c]
*** TURN *** [Qs As 2c] [7s]
*** RIVER *** [Qs As 2c 7s] [8s]
*** SHOW DOWN ***
Adios89: shows [8h 8d] (three of a kind, Eights)
R@nTAnpl@N: shows [Ah 3h] (a pair of Aces)
Adios89 collected 11402 from pot
*** SUMMARY ***
Total pot 11402 | Rake 0 
Board [Qs As 2c 7s 8s]
Seat 1: hironisisaka folded before Flop (didn't bet)
Seat 2: FIZZE76 folded before Flop (didn't bet)
Seat 3: DRAGOS FCSB folded before Flop (didn't bet)
Seat 4: R@nTAnpl@N showed [Ah 3h] and lost with a pair of Aces
Seat 5: Fakhish folded before Flop (didn't bet)
Seat 6: zas91 (button) folded before Flop (didn't bet)
Seat 7: LtGrimms (small blind) folded before Flop
Seat 8: Adios89 (big blind) showed [8h 8d] and won (11402) with three of a kind, Eights
Seat 9: MoKoZoBa folded before Flop (didn't bet)



PokerStars Hand #139424116022: Tournament #1292680929, $10+$1 USD Hold'em No Limit - Level XV (300/600) - 2015/08/15 15:49:55 ET
Table '1292680929 17' 9-max Seat #7 is the button
Seat 1: hironisisaka (12956 in chips) 
Seat 2: FIZZE76 (11464 in chips) 
Seat 3: DRAGOS FCSB (6237 in chips) 
Seat 4: R@nTAnpl@N (89 in chips) 
Seat 5: Fakhish (8170 in chips) 
Seat 6: zas91 (10024 in chips) 
Seat 7: LtGrimms (8101 in chips) 
Seat 8: Adios89 (11402 in chips) 
Seat 9: MoKoZoBa (5556 in chips) 
hironisisaka: posts the ante 70
FIZZE76: posts the ante 70
DRAGOS FCSB: posts the ante 70
R@nTAnpl@N: posts the ante 70
Fakhish: posts the ante 70
zas91: posts the ante 70
LtGrimms: posts the ante 70
Adios89: posts the ante 70
MoKoZoBa: posts the ante 70
Adios89: posts small blind 300
MoKoZoBa: posts big blind 600
*** HOLE CARDS ***
Dealt to LtGrimms [Qs 9c]
hironisisaka: folds 
FIZZE76: folds 
DRAGOS FCSB: folds 
R@nTAnpl@N: calls 19 and is all-in
Fakhish: folds 
zas91: folds 
LtGrimms: folds 
Adios89: folds 
Uncalled bet (300) returned to MoKoZoBa
*** FLOP *** [Th Jh 3c]
*** TURN *** [Th Jh 3c] [As]
*** RIVER *** [Th Jh 3c As] [8h]
*** SHOW DOWN ***
MoKoZoBa: shows [7c 7s] (a pair of Sevens)
MoKoZoBa collected 562 from side pot
R@nTAnpl@N: shows [5h 9s] (high card Ace)
MoKoZoBa collected 687 from main pot
R@nTAnpl@N finished the tournament in 137th place
*** SUMMARY ***
Total pot 1249 Main pot 687. Side pot 562. | Rake 0 
Board [Th Jh 3c As 8h]
Seat 1: hironisisaka folded before Flop (didn't bet)
Seat 2: FIZZE76 folded before Flop (didn't bet)
Seat 3: DRAGOS FCSB folded before Flop (didn't bet)
Seat 4: R@nTAnpl@N showed [5h 9s] and lost with high card Ace
Seat 5: Fakhish folded before Flop (didn't bet)
Seat 6: zas91 folded before Flop (didn't bet)
Seat 7: LtGrimms (button) folded before Flop (didn't bet)
Seat 8: Adios89 (small blind) folded before Flop
Seat 9: MoKoZoBa (big blind) showed [7c 7s] and won (1249) with a pair of Sevens



PokerStars Hand #139424148407: Tournament #1292680929, $10+$1 USD Hold'em No Limit - Level XV (300/600) - 2015/08/15 15:50:35 ET
Table '1292680929 17' 9-max Seat #8 is the button
Seat 1: hironisisaka (12886 in chips) 
Seat 2: FIZZE76 (11394 in chips) 
Seat 3: DRAGOS FCSB (6167 in chips) 
Seat 5: Fakhish (8100 in chips) 
Seat 6: zas91 (9954 in chips) 
Seat 7: LtGrimms (8031 in chips) 
Seat 8: Adios89 (11032 in chips) 
Seat 9: MoKoZoBa (6435 in chips) 
hironisisaka: posts the ante 70
FIZZE76: posts the ante 70
DRAGOS FCSB: posts the ante 70
Fakhish: posts the ante 70
zas91: posts the ante 70
LtGrimms: posts the ante 70
Adios89: posts the ante 70
MoKoZoBa: posts the ante 70
MoKoZoBa: posts small blind 300
hironisisaka: posts big blind 600
*** HOLE CARDS ***
Dealt to LtGrimms [7d As]
FIZZE76: folds 
DRAGOS FCSB: folds 
Fakhish: raises 7430 to 8030 and is all-in
zas91: folds 
LtGrimms: folds 
Adios89: folds 
MoKoZoBa: folds 
hironisisaka: folds 
Uncalled bet (7430) returned to Fakhish
Fakhish collected 2060 from pot
*** SUMMARY ***
Total pot 2060 | Rake 0 
Seat 1: hironisisaka (big blind) folded before Flop
Seat 2: FIZZE76 folded before Flop (didn't bet)
Seat 3: DRAGOS FCSB folded before Flop (didn't bet)
Seat 5: Fakhish collected (2060)
Seat 6: zas91 folded before Flop (didn't bet)
Seat 7: LtGrimms folded before Flop (didn't bet)
Seat 8: Adios89 (button) folded before Flop (didn't bet)
Seat 9: MoKoZoBa (small blind) folded before Flop



PokerStars Hand #139424169715: Tournament #1292680929, $10+$1 USD Hold'em No Limit - Level XV (300/600) - 2015/08/15 15:51:02 ET
Table '1292680929 17' 9-max Seat #9 is the button
Seat 1: hironisisaka (12216 in chips) 
Seat 2: FIZZE76 (11324 in chips) 
Seat 3: DRAGOS FCSB (6097 in chips) 
Seat 4: carl.1411 (16109 in chips) 
Seat 5: Fakhish (9490 in chips) 
Seat 6: zas91 (9884 in chips) 
Seat 7: LtGrimms (7961 in chips) 
Seat 8: Adios89 (10962 in chips) 
Seat 9: MoKoZoBa (6065 in chips) 
hironisisaka: posts the ante 70
FIZZE76: posts the ante 70
DRAGOS FCSB: posts the ante 70
carl.1411: posts the ante 70
Fakhish: posts the ante 70
zas91: posts the ante 70
LtGrimms: posts the ante 70
Adios89: posts the ante 70
MoKoZoBa: posts the ante 70
hironisisaka: posts small blind 300
FIZZE76: posts big blind 600
*** HOLE CARDS ***
Dealt to LtGrimms [7d Ah]
DRAGOS FCSB: folds 
carl.1411: folds 
Fakhish: folds 
zas91: raises 9214 to 9814 and is all-in
LtGrimms: folds 
Adios89: folds 
MoKoZoBa: folds 
hironisisaka: folds 
FIZZE76: folds 
Uncalled bet (9214) returned to zas91
zas91 collected 2130 from pot
zas91: doesn't show hand 
*** SUMMARY ***
Total pot 2130 | Rake 0 
Seat 1: hironisisaka (small blind) folded before Flop
Seat 2: FIZZE76 (big blind) folded before Flop
Seat 3: DRAGOS FCSB folded before Flop (didn't bet)
Seat 4: carl.1411 folded before Flop (didn't bet)
Seat 5: Fakhish folded before Flop (didn't bet)
Seat 6: zas91 collected (2130)
Seat 7: LtGrimms folded before Flop (didn't bet)
Seat 8: Adios89 folded before Flop (didn't bet)
Seat 9: MoKoZoBa (button) folded before Flop (didn't bet)



PokerStars Hand #139424201789: Tournament #1292680929, $10+$1 USD Hold'em No Limit - Level XV (300/600) - 2015/08/15 15:51:41 ET
Table '1292680929 17' 9-max Seat #1 is the button
Seat 1: hironisisaka (11846 in chips) 
Seat 2: FIZZE76 (10654 in chips) 
Seat 3: DRAGOS FCSB (6027 in chips) 
Seat 4: carl.1411 (16039 in chips) 
Seat 5: Fakhish (9420 in chips) 
Seat 6: zas91 (11344 in chips) 
Seat 7: LtGrimms (7891 in chips) 
Seat 8: Adios89 (10892 in chips) 
Seat 9: MoKoZoBa (5995 in chips) 
hironisisaka: posts the ante 70
FIZZE76: posts the ante 70
DRAGOS FCSB: posts the ante 70
carl.1411: posts the ante 70
Fakhish: posts the ante 70
zas91: posts the ante 70
LtGrimms: posts the ante 70
Adios89: posts the ante 70
MoKoZoBa: posts the ante 70
FIZZE76: posts small blind 300
DRAGOS FCSB: posts big blind 600
*** HOLE CARDS ***
Dealt to LtGrimms [9c 6s]
carl.1411: folds 
Fakhish: folds 
zas91: folds 
LtGrimms: folds 
Adios89: folds 
MoKoZoBa: raises 5325 to 5925 and is all-in
hironisisaka: folds 
FIZZE76: folds 
DRAGOS FCSB: folds 
Uncalled bet (5325) returned to MoKoZoBa
MoKoZoBa collected 2130 from pot
*** SUMMARY ***
Total pot 2130 | Rake 0 
Seat 1: hironisisaka (button) folded before Flop (didn't bet)
Seat 2: FIZZE76 (small blind) folded before Flop
Seat 3: DRAGOS FCSB (big blind) folded before Flop
Seat 4: carl.1411 folded before Flop (didn't bet)
Seat 5: Fakhish folded before Flop (didn't bet)
Seat 6: zas91 folded before Flop (didn't bet)
Seat 7: LtGrimms folded before Flop (didn't bet)
Seat 8: Adios89 folded before Flop (didn't bet)
Seat 9: MoKoZoBa collected (2130)



PokerStars Hand #139424221733: Tournament #1292680929, $10+$1 USD Hold'em No Limit - Level XV (300/600) - 2015/08/15 15:52:06 ET
Table '1292680929 17' 9-max Seat #2 is the button
Seat 1: hironisisaka (11776 in chips) 
Seat 2: FIZZE76 (10284 in chips) 
Seat 3: DRAGOS FCSB (5357 in chips) 
Seat 4: carl.1411 (15969 in chips) 
Seat 5: Fakhish (9350 in chips) 
Seat 6: zas91 (11274 in chips) 
Seat 7: LtGrimms (7821 in chips) 
Seat 8: Adios89 (10822 in chips) 
Seat 9: MoKoZoBa (7455 in chips) 
hironisisaka: posts the ante 70
FIZZE76: posts the ante 70
DRAGOS FCSB: posts the ante 70
carl.1411: posts the ante 70
Fakhish: posts the ante 70
zas91: posts the ante 70
LtGrimms: posts the ante 70
Adios89: posts the ante 70
MoKoZoBa: posts the ante 70
DRAGOS FCSB: posts small blind 300
carl.1411: posts big blind 600
*** HOLE CARDS ***
Dealt to LtGrimms [Qs Qh]
Fakhish: folds 
zas91: raises 600 to 1200
LtGrimms: calls 1200
Adios89: raises 9552 to 10752 and is all-in
MoKoZoBa: folds 
hironisisaka: folds 
FIZZE76: folds 
DRAGOS FCSB: folds 
carl.1411: folds 
zas91: folds 
LtGrimms: calls 6551 and is all-in
Uncalled bet (3001) returned to Adios89
*** FLOP *** [Td 3d 8c]
*** TURN *** [Td 3d 8c] [Kc]
*** RIVER *** [Td 3d 8c Kc] [Ad]
*** SHOW DOWN ***
LtGrimms: shows [Qs Qh] (a pair of Queens)
Adios89: shows [Kd Ac] (two pair, Aces and Kings)
Adios89 collected 18232 from pot
LtGrimms finished the tournament in 125th place
*** SUMMARY ***
Total pot 18232 | Rake 0 
Board [Td 3d 8c Kc Ad]
Seat 1: hironisisaka folded before Flop (didn't bet)
Seat 2: FIZZE76 (button) folded before Flop (didn't bet)
Seat 3: DRAGOS FCSB (small blind) folded before Flop
Seat 4: carl.1411 (big blind) folded before Flop
Seat 5: Fakhish folded before Flop (didn't bet)
Seat 6: zas91 folded before Flop
Seat 7: LtGrimms showed [Qs Qh] and lost with a pair of Queens
Seat 8: Adios89 showed [Kd Ac] and won (18232) with two pair, Aces and Kings
Seat 9: MoKoZoBa folded before Flop (didn't bet)



